┼进制	十进制
阿巴日嗄旗	阿巴日嘎旗
阿尔发粒	阿尔法粒子
阿尔太山	阿尔泰山
阿耳发	阿尔法
阿公店水	阿公店水库
阿基米得原理	阿基米德原理
阿加尼压	阿加尼亚
阿们	阿门
阿帕拉契山径	阿帕拉契山脉
阿赛拜疆	阿塞拜疆
阿司匹灵	阿司匹林
阿斯匹林	阿司匹林
阿斯匹灵	阿司匹林
阿呀	啊呀
哀肠寸断	肝肠寸断
哀声叹气	唉声叹气
哀恸不已	哀痛不已
唉呀	哎呀
唉哟	哎哟
埃个儿	挨个儿
捱肩擦背	挨肩擦背
嗳呀	哎呀
蔼然可观	蔼然可亲
霭然	蔼然
霭然可亲	蔼然可亲
艾莉丝	艾丽丝
艾丽丝	艾丽丝
艾丽斯	艾丽丝
艾文格	艾文荷
爱得华	爱德华
爱护倍至	爱护备至
爱口失羞	碍口识羞
爱口识羞	碍口识羞
爱寞能助	爱莫能助
爱幕	爱慕
爱如已出	爱如己出
爱窝窝	艾窝窝
爱乌及屋	爱屋及乌
爱屋及鸟	爱屋及乌
爱物及乌	爱屋及乌
爱则加诸膝恶则坠诸渊	爱则加诸膝，恶则坠诸渊
爱增分明	爱憎分明
爱之欲其生恶之欲其死	爱之欲其生，恶之欲其死
爱滋	艾滋
爱滋病	艾滋病
爱滋病病毒	艾滋病病毒
爱滋病患者	艾滋病患者
暧色	暖色
安兵不动	按兵不动
安步当年	安步当车
安部就班	按部就班
安常故	安常习故
安地斯山	安第斯山
安非他明	安非他命
安分守纪	安分守己
安份	安分
安份守己	安分守己
安富恤究	安富恤穷
安哥位	安哥拉
安格拉	安哥拉
安格鲁萨克逊	盎格鲁萨克逊
安眠	安眠药
安捺	按捺
安如盘石	安如磐石
安如太山	安如泰山
安祥	安详
安心落意	安心乐意
安溢	安谧
安于故俗溺于旧闻	安于故俗，溺于旧闻
安于盘石	安于磐石
安於盘石	安于磐石
安於现状	安于现状
安之若泰	安之若素
安之偌素	安之若素
安置若素	安之若素
鞍不离马甲不离身	鞍不离马，甲不离身
鞍前马後	鞍前马后
室不欺	暗室不欺
无天日	暗无天日
子	埯子
按步就班	按部就班
按健	按键
按纳	按捺
按耐	按捺
按图索迹	按图索骥
按途索骥	按图索骥
按验	案验
按装	安装
按装机器	安装机器
案语	按语
胺基酸	氨基酸
暗暗忖思	暗暗思忖
暗度陈仓	暗渡陈仓
暗度陈昌	暗渡陈仓
暗茂	暗藏
暗然	黯然
暗然神伤	黯然神伤
暗然失色	黯然失色
暗然消魂	黯然销魂
暗然销魂	黯然销魂
黯然消魂	黯然销魂
盎斯	盎司
熬恼	懊恼
熬清受淡	熬清守淡
翱游四海	遨游四海
里夺尊	鳌里夺尊
头独占	鳌头独占
掷鲸	鳌掷鲸
掷鲸吞	鳌掷鲸吞
奥大利亚	澳大利亚
奥得河	奥德河
奥勒冈州	俄勒冈州
奥秒	奥妙
奥塞罗	奥赛罗
奥斯戮	奥斯陆
澳地利	奥地利
懊	懊恼
八公山上草木皆兵	八公山上，草木皆兵
八面⒙珑	八面玲珑
八拿马	巴拿马
八仙过海各显其能	八仙过海，各显其能
八仙过海各显神通	八仙过海，各显神通
八字贴	八字帖
八字贴儿	八字帖儿
巴高枝	巴高枝儿
巴焦	芭蕉
巴蕾午团	芭蕾舞团
巴罗克	巴洛克
巴那马	巴拿马
叭儿狗	巴儿狗
扒犁	爬犁
疤拉	疤瘌
拔粹	拔萃
拔打	拨打
拔电话	拨电话
拔动	拨动
拔付	拨付
拔给	拨给
拔号上网	拨号上网
拔号网络	拨号网络
拔户	跋扈
拔扈	跋扈
拔回	拨回
拔叫	拨叫
拔款	拨款
拔乱反正	拨乱反正
拔茅连茹	拔毛连茹
拔弄	拨弄
拔入	拨入
拔涉	跋涉
拔通	拨通
拔用	拨用
拔宅飞N	拔宅飞升
拔宅上N	拔宅上升
跋户	跋扈
跋前d後	跋前d后
跋前F後	跋前F后
跋前踬后	跋前F后
跋前踬後	跋前踬后
跋涉水	跋山涉水
把当做	把当作
把势	把式
罢于奔命	疲于奔命
罢於奔命	罢于奔命
白壁微暇	白璧微瑕
白壁微瑕	白璧微瑕
白壁无暇	白璧无瑕
白壁无瑕	白璧无瑕
白璧无暇	白璧无瑕
白川归海	百川归海
白癫风	白癜风
白癫疯	白癜风
白花功夫	白花工夫
白袷蓝衫	白夹蓝衫
白驹过郄	白驹过隙
白驹过S	白驹过隙
白	白蒙蒙
白日飞N	白日飞升
白日上N	白日上升
白日N天	白日升天
白日作梦	白日做梦
白沙糖	白砂糖
白沙在涅与之俱黑	白沙在涅，与之俱黑
白首空望	白首空归
白头携老	白头偕老
百般推委	百般推诿
百步川杨	百步穿杨
百步穿场	百步穿杨
百步穿扬	百步穿杨
百尺杆头	百尺竿头
百尺竿头更进一步	百尺竿头，更进一步
百废具举	百废俱举
百废具兴	百废俱兴
百废具作	百废俱作
百感交加	百感交集
百家争呜	百家争鸣
百孔千窗	百孔千疮
百孔千创	百孔千疮
百练成钢	百炼成钢
百链成钢	百炼成钢
百慕达	百慕大
百年不迂	百年不遇
百年难迂	百年难遇
百舍重茧	百舍重趼
百万买宅千万买邻	百万买宅，千万买邻
百无聊奈	百无聊赖
百无一见	百无一用
百无一事	百无一是
百务具举	百务俱举
百页窗	百叶窗
百衣百随	百依百随
百战不怠	百战不殆
百摺裙	百褶裙
百足之虫死而不僵	百足之虫，死而不僵
百足之x	百足之虫
摆脱漩涡	摆脱旋涡
败家仔	败家子
败事有馀，成事不足	败事有余，成事不足
败也肖何	败也萧何
败由	败因
败於垂成	败于垂成
拜倒石榴裙之下	石榴裙之下
稗益	裨益
扳龙附凤	攀龙附凤
扳起脸孔	板起脸孔
扳谈	攀谈
班白	斑白
班驳	斑驳
班驳陆离	斑驳陆离
班陆离	斑驳陆离
班斓	斑斓
班马	斑马
班配	般配
般缠	盘缠
颁白	斑白
斑陆离	斑驳陆离
斑谰炫目	斑斓炫目
搬不倒	扳不倒
搬递舌	搬唇递舌
搬弄舌	搬唇弄舌
搬门弄斧	班门弄斧
板上丁丁	板上钉钉
板上走丸	坂上走丸
板粟	板栗
板筑	版筑
办公	办公台
半璧江山	半壁河山
半工半续	半工半读
半节话	半截话
半身不摄	半身不遂
半统靴	半筒靴
半途而C	半途而废
半响	半晌
伴时宰相	伴食宰相
邦助邦助	帮助帮助
帮f钻懒	帮闲钻懒
傍观冷眼	旁观冷眼
傍观者清	旁观者清
傍观者审，当局者迷	旁观者审，当局者迷
傍徨	彷徨
傍门左道	旁门左道
傍若无人	旁若无人
傍系	旁系
棒棰	棒槌
棒锤	棒槌
厢	彷徨
厢迨Т	彷徨失措
包罗万像	包罗万象
苞藏祸心	包藏祸心
苞谷	包谷
苞米	包米
胞子	孢子
褒庇	包庇
J衣博带	褒衣博带
宝茂	宝藏
宝臧	宝藏
饱食终日无所用心	饱食终日，无所用心
饱有偏见	抱有偏见
饱涨	饱胀
保镳	保镖
保残守缺	抱残守缺
保护人身分	保护人身份
保茂	保藏
保母	保姆
保票	包票
保v	保佑
褓母	保姆
褓姆	保姆
报仇血耻	报仇雪耻
报导	报道
报导文学	报道文学
报道失时	报道失实
报国之材	报国之才
报消车费	报销车费
报帐	报账
报竹平安	竹报平安
抱关执a	抱关执龠
抱Y灌园	抱瓮灌园
鲍鱼之次	鲍鱼之肆
暴发力	爆发力
暴光	曝光
暴戾姿睢	暴戾恣睢
暴殓天物	暴殄天物
暴露无疑	暴露无遗
暴腮龙门	曝鳃龙门
暴鳃龙门	曝鳃龙门
暴徙	暴徒
暴燥	暴躁
暴燥如雷	暴躁如雷
爆炸事业	爆炸事件
卑词厚礼	卑辞厚礼
卑恭屈膝	卑躬屈膝
卑躬曲膝	卑躬屈膝
杯盘狼籍	杯盘狼藉
悲忿	悲愤
悲愤填鹰	悲愤填膺
悲歌慨	悲歌慷慨
悲观主意	悲观主义
悲呜	悲鸣
d包袱	背包袱
d负	背负
d黑锅	背黑锅
碑贴	碑帖
碑帖临摩	碑帖临摹
北	北疆
北山酒精	北山酒经
北辕m楚	北辕适楚
北辕m粤	北辕适粤
备分	备份
背不住	备不住
背褡子	背搭子
背道而弛	背道而驰
背晦	悖晦
背理	悖理
背谬	悖谬
背前面後	背前面后
倍藏艰辛	备尝艰辛
倍出	辈出
倍受欢迎	备受欢迎
倍受青睐	备受青睐
倍至	备至
悖时	背时
被褡子	背搭子
被发详狂	被发佯狂
被发阳狂	被发佯狂
被复	被覆
被徵召的	被征召的
被p佩紫	被朱佩紫
辈份	辈分
本份	本分
本科文化	本科文凭
本未倒置	本末倒置
苯鸟先飞	笨鸟先飞
M胝	胼胝
逼不得已	必不得已
逼上粱上	逼上梁山
鼻塌青	鼻塌唇青
比画	比划
比肩连袂	比肩联袂
比浓粘度	比浓黏度
比上不足，比下有馀	比上不足，比下有余
比上不足比下有余	比上不足，比下有余
比	比湿
比以任何时候都	比以往任何时候都
比以往任何时侯	比以往任何时候
比以往任何时侯都	比以往任何时候都
比粘度	比黏度
彼彼皆是	比比皆是
彼倡此和	彼唱此和
彼一时此一时	彼一时，此一时
俾阖	捭阖
俾阖纵横	捭阖纵横
笔划	笔画
笔门造车	闭门造车
笔名着作	笔名著作
笔谭	笔谈
笔下生辉	笔下生花
笔心	笔芯
鄙帚自珍	敝帚自珍
必恭必敬	毕恭毕敬
必竟	毕竟
必露	毕露
毕竞	毕竟
毕竞是	毕竟是
毕路篮缕	筚路蓝缕
闭关自首	闭关自守
哔哩啪啦	噼里啪啦
荜路兰缕	筚路蓝缕
荜路蓝缕	筚路蓝缕
荜路缕	筚路蓝缕
敝开	敞开
敝开肚子	敞开肚子
敝开着的	敞开着的
敝恶粟	敝绨恶粟
敝徙	敝屣
筚篥	v篥
筚门闺窦	筚门圭窦
b臆	弦
裨官	稗官
裨官野史	稗官野史
辟立千仞	壁立千仞
辟头	劈头
弊车赢马	弊车羸马
巍┌剥	伟剥
碧雪丹心	碧血丹心
蔽帚自珍	敝帚自珍
壁还	璧还
篦麻油	蓖麻油
篦麻子	蓖麻子
v栗	v篥
避护	庇护
避护缺点	庇护缺点
避入坑	避阱入坑
避其锐气击其惰归	避其锐气，击其惰归
避日	蔽日
避署山庄	避暑山庄
避之惟恐不及	避之唯恐不及
边垂	边陲
边垂小镇	边陲小镇
编安	偏安
编篡	编纂
编篡者	编纂者
编篡字典	编纂字典
编辑按	编者按
编结鱼网	编结渔网
编者案	编者按
编织鱼网	编织渔网
编着	编著
q豆	扁豆
煸情电影	煽情电影
煸情影片	煽情影片
鞭苔	鞭笞
鞭苔三百	鞭笞三百
贬眼	眨眼
H豆	扁豆
x豆	扁豆
\风润	\风舞润
拚了性命	拼了性命
拚死	拼死
拚死拚活	拼死拼活
拚死搏斗	拼死搏斗
拚死相斗	拼死相斗
拚他个	拼他个
变本加利	变本加厉
变本加励	变本加厉
变幻莫侧	变幻莫测
变换莫测	变幻莫测
变天帐	变天账
变宜	便宜
变宜行事	便宜行事
遍不	偏不
遍废	偏废
辨白	辩白
辨才无碍	辩才无碍
辨正论冶	辨证论治
辨正施冶	辩证施治
辨证法	辩证法
辨证法　	辩证法
辨证唯物主义	辩证唯物主义
辨证之法	辩证之法
辨症	辨证
辩别	辨别
辩辞	辩词
杓子	勺子
标新立意	标新立异
骠悍	剽悍
飚升	飙升
表出来	标出来
表春气盛	青春气盛
憋脚	蹩脚
别拔	别拨
别别扭忸	别别扭扭
别出心栽	别出心裁
别出新裁	别出心裁
别来无羔	别来无恙
别树一格	别树一帜
别作梦	别做梦
县	彬县
宾T日月	宾饯日月
宾夕凡尼亚	宾西法尼亚
宾夕凡尼亚州	宾夕法尼亚洲
宾西法尼亚	宾夕法尼亚
滨临	濒临
槟	槟树
鬓脚	鬓角
冰冻三尺非一日之寒	冰冻三尺，非一日之寒
冰寒於水	冰寒于水
冰块溶化	冰块融化
冰快	冰块
冰浊镌	冰壶秋月
冰其淋	冰淇淋
冰上巴蕾	冰上芭蕾
冰炭不言冷热自明	冰炭不言，冷热自明
冰天雪窑	冰天雪窖
冰雪消溶	冰雪消融
冰窑	冰窖
冰枝玉杆	冰枝玉干
兵不@刃	兵不污刃
兵不雪刃	兵不血刃
兵慌马乱	兵荒马乱
兵来将挡，水来土淹	兵来将挡，水来土掩
兵来将挡水来土淹	兵来将挡，水来土掩
兵来将挡水来土掩	兵来将挡，水来土掩
兵连涡结	兵连祸结
兵马未动粮草先行	兵马未动，粮草先行
兵祸结	兵弩祸结
丙烯荃	丙烯醛
秉烛夜行	秉烛夜游
禀承	秉承
并驾齐躯	并驾齐驱
并容谈	并容遍覆
并题	并提
并行不背	并行不悖
病毒颗	病毒科
病人膏盲	病入膏肓
病入膏荒	病入膏肓
病入膏盲	病入膏肓
拨地摇山	拔地摇山
拨地倚天	拔地倚天
拨犀擢象	拔犀擢象
拨宅上升	拔宅上升
波多黎哥	波多黎各
波澜状阔	波澜壮阔
波浪鼓	拨浪鼓
波浪涛涛	波浪滔滔
波利维亚	玻利维亚
波罗地海	波罗的海
波罗密	波罗蜜
波罗密多	波罗蜜多
波丝菊	波斯菊
波滔滚滚	波涛滚滚
波折号	破折号
玻尔兹曼	波尔兹曼
剥谱	波谱
脖梗儿	脖颈儿
播^眯目	播糠眯目
伯明罕	伯明翰
伯兹瓦纳	博茨瓦纳
孛理	悖理
孛论	悖论
泊来品	舶来品
勃H	勃G
博大经深	博大精深
博览群集	博览群书
博浪鼓	拨浪鼓
博文强记	博闻强记
博文强识	博闻强识
博治	博洽
博治多闻	博洽多闻
薄砂地	薄沙地
薄往细故	薄物细故
薄云见日	拨云见日
簸扬糠z	簸扬糠秕
锴	m峭
逋峭	m峭
补钉	补丁
补w	补丁
补已之短	补己之短
不安份	不安分
不安於室	不安于室
不卑不抗	不卑不亢
不卑不坑	不卑不亢
不贬眼	不眨眼
不贬眼　	不眨眼
不贬眼睛	不眨眼睛
不辨椒麦	不辨菽麦
不辨菽黍	不辨菽麦
不辨黍麦	不辨菽麦
不辩菽麦	不辨菽麦
不	不变
不齿下问	不耻下问
不覆	不瞅不睬
不大光采	不大光彩
不当之外	不当之处
不纺一试	不妨一试
不分o白	不分皂白
不分皂分	不分皂白
不奋功夫	不费工夫
不孚众望	不负众望
不负存在	不复存在
不敢想象	不敢想像
不共戴大	不共戴天
不光采	不光彩
不寒而	不寒而栗
不寒而粟	不寒而栗
不己	不已
不记其数	不计其数
不加思索	不假思索
不间断电沅	不间断电源
不见棺材不流掉泪	不见棺材不掉泪
不见经付	不见经传
不娇不躁	不骄不躁
不骄不燥	不骄不躁
不较充分	必较充分
不较精细	必较精细
不较直观	必较直观
不较周密	必较周密
不结盟运	不结盟运动
不紧不离	不即不离
不尽长江滚滚流	不尽长江滚滚来
不尽人情	不近人情
不禁意	不经意
不经一事不长一智	不经一事，不长一智
不颈而走	不胫而走
不径而走	不胫而走
不纠	不咎
不看憎面看佛面	不看僧面看佛面
不苛颜笑	不苟言笑
不可遍废	不可偏废
不可撤消	不可撤销
不可调合	不可调和
不可救	不可救药
不可明状	不可名状
不可僻免	不可避免
不可思义	不可思议
不可讨究	不可深究
不可想象	不可想像
不肯降伏	不肯降附
不下学	不愧下学
不稂不秀	不稂不莠
不露锋	不露锋芒
不论什麽	不论什么
不落巢臼	不落窠臼
不买帐	不买账
不明身分	不明身份
不明一钱	不名一钱
不牟名利	不谋名利
不牟私利	不谋私利
不奈烦	不耐烦
不难想象	不难想像
不能想象	不能想像
不能自己	不能自已
不能自恃	不能自持
不期而迂	不期而遇
不欺室	不欺暗室
不乾不净	不干不净
不求有功但求无过	不求有功，但求无过
不认帐	不认账
不容分辨	不容分辩
不容置啄	不容置喙
不入虎穴焉得虎子	不入虎穴，焉得虎子
不塞下流	不塞不流
不塞下流，不止不行	不塞不流，不止不行
不塞下流不止不行	不塞不流，不止不行
不胜杯杓	不胜杯勺
不胜G杓	不胜杯勺
不胜其繁	不胜其烦
不失黍t	不失黍累
不识庐山真面目只缘身在此山中	不识庐山真面目，只缘身在此山中
不识人体	不识大体
不事不妙	大事不妙
不思好歹	不识好歹
不算光采	不算光彩
不听老人言吃亏在眼前	不听老人言，吃亏在眼前
不瘟不火	不温不火
不问o白	不问皂白
不务止业	不务正业
不希罕	不稀罕
不息地旋转	不停地旋转
不地土	不习地土
不水土	不习水土
不遐	不暇
不陷于	不限于
不象	不像
不象父亲	不像父亲
不象话	不像话
不象样	不像样
不宵	不屑
不宵一顾	不屑一顾
不孝子孙	不肖子孙
不屑置辨	不屑置辩
不幸中的大幸	不幸中之大幸
不边幅	不修边幅
不荀	不苟
不荀言笑	不苟言笑
不循私情	不徇私情
不殉私情	不徇私情
不言而明	不言而喻
不言而谕	不言而喻
不厌其繁	不厌其烦
不壹而三	不一而三
不壹而足	不一而足
不遗馀力	不遗余力
不以辞害志	不以辞害意
不以规矩不能成方圆	不以规矩，不能成方圆
不易而论	不易之论
不逾	不渝
不远万理	不远万里
不在其位不谋其政	不在其位，不谋其政
不泽手段	不择手段
不知所错	不知所措
不知有汉何论魏晋	不知有汉，何论魏晋
不值一晒	不值一哂
不致于	不至于
不著边际	不着边际
不自由毋宁死	不自由，毋宁死
不足为外	不足为外人道
不作声	不做声
不@手药	不龟手药
布c无恙	布帆无恙
布b鸟	布谷鸟
布署	部署
布署已定	部署已定
步履踉伧	步履踉跄
步人正规	步入正轨
步人正轨	步入正轨
步入后尘	步人后尘
步入正规	步入正轨
部份	部分
部暑	部署
部属工作	部署工作
才舒学浅	才疏学浅
材高知深	材高智深
材茂行e	材茂行洁
材优旨	材优干济
财礼	彩礼
财务建帐	财务建账
采笔生花	彩笔生花
采灯	彩灯
采凤随鸦	彩凤随鸦
采票债券	彩票债券
采旗招展	彩旗招展
采衣娱亲	彩衣娱亲
睬精	采精
踩高橇	踩高跷
菜兰子工程	菜篮子工程
菜子	菜籽
菜子油	菜籽油
蔡依林	蔡依琳
参禅佛事	参禅事佛
参葺	参茸
参巧文献	参考文献
参予	参与
参预	参与
残膏馥	残膏剩馥
残更冷炙	残羹冷炙
残羹冷汁	残羹冷炙
残留影象	残留影像
残冷炙	残盘冷炙
残山水	残山剩水
残无人道	惨无人道
残渣馀孽	残渣余孽
惨澹	惨淡
惨澹经营	惨淡经营
惨绝人寡	惨绝人寰
惨绝人环	惨绝人寰
惨酷	残酷
惨酷无情	残酷无情
惨遭屠戳	惨遭屠戮
仓猝	仓促
仓庚	]f
仓海桑田	沧海桑田
仓黄	仓皇
仓遑	仓皇
仓卒	仓促
沧海一栗	沧海一粟
苍黄翻复	苍黄翻覆
苍莽	苍茫
藏龙臣虎	藏龙卧虎
藏天朔	臧天朔
藏之名山传之其人	藏之名山，传之其人
草管	草菅
草管人命	草菅人命
草木葱笼	草木葱茏
草木犀	草木樨
草似的	草拟的
侧臣	侧卧
侧面影象	侧面影像
恻隐之心人皆有之	恻隐之心，人皆有之
奸	鸡奸
策画	策划
层层迭迭	层层叠叠
层层绿荫	层层绿阴
层迭	层叠
层见迭出	层见叠出
层峦迭嶂	层峦叠嶂
层峦叠翠	层峦叠嶂
插科打浑	插科打诨
插血为盟	歃血为盟
查对帐目	查对账目
查觉到	察觉到
查良庸	查良镛
查帐	查账
查帐员	查账员
茶毒	荼毒
茶毒生灵	荼毒生灵
茶花会	茶话会
茶色眼睛	茶色眼镜
茶馀饭後	茶余饭后
茶馀酒後	茶余酒后
搽汗	擦汗
察颜观色	察言观色
碴砑山	酷山
g紫焉红	姹紫嫣红
g紫嫣红	姹紫嫣红
汊流	岔流
y	髻
姹紫焉红	姹紫嫣红
姹紫妍红	姹紫嫣红
差迟	差池
差人意	差强人意
差若毫，谬以千里	差若毫厘，谬以千里
差透	参透
差透义理	参透义理
差以毫厘失之千里	差以毫厘，失之千里
差之毫厘谬以千里	差之毫厘，谬以千里
差之毫厘失之千里	差之毫厘，失之千里
差之毫樱失之千里	差之毫厘，失之千里
差之毫，谬以千里	差之毫厘，谬以千里
差之毫，失之千里	差之毫厘，失之千里
拆帐	拆账
柴高夫斯基	柴科夫斯基
豺死留皮	豹死留皮
搀兑	掺兑
搀和	掺和
搀假	掺假
搀杂	掺杂
搀杂私心	掺杂私心
搀杂在	掺杂在
搀杂着	掺杂着
v前落後	搀前落后
v行夺市	搀行夺市
谗涎欲滴	馋涎欲滴
谗言欲滴	馋涎欲滴
蝉腹@肠	蝉腹龟肠
蝉翼为重千钧为轻	蝉翼为重，千钧为轻
i除	铲除
}草除根	铲草除根
}恶锄奸	铲恶锄奸
}旧谋新	铲旧谋新
颤栗	战栗
颤栗者	战栗者
羼杂	掺杂
伥然	怅然
伥然若失	怅然若失
猖撅	猖獗
长备	常备
长备不懈	常备不懈
长春藤	常春藤
长方型	长方形
长江三角州	长江三角洲
长虑顾後	长虑顾后
长虑後顾	长虑后顾
长虑s顾	长虑却顾
长念s虑	长念却虑
长篇累犊	长篇累牍
长趋直入	长驱直入
长舌夫	长舌妇
长胜不衰	长盛不衰
长g远略	长算远略
长他人志气灭自己威风	长他人志气，灭自己威风
长统	长筒
长统袜	长筒袜
长途拔涉	长途跋涉
长途直拔	长途直拨
长袖善午	长袖善舞
长嘘短叹	长吁短叹
长志市	长治市
长住人口	常住人口
长著刺	长着刺
常白山	长白山
常年累月	长年累月
常期性	长期性
常盛不衰	长盛不衰
来去	尝来尝去
场声器	扬声器
惝恍	惝U
敞开想象	敞开想像
敞蓬车	敞篷车
倡而不和	唱而不和
唱独脚戏	唱独角戏
唱工	唱功
辰醒锛	畅叫扬疾
乘欲为	畅所欲为
乘欲言	畅所欲言
超凡人圣	超凡入圣
超凡入胜	超凡入圣
超乎想象	超乎想像
超前绝後	超前绝后
超前轶後	超前轶后
巢臼	窠臼
朝成暮	朝成暮遍
朝纲崩杯	朝纲崩坏
朝啄豪	朝欢暮乐
朝气篷勃	朝气蓬勃
朝乾夕	朝乾夕惕
朝秦幕楚	朝秦暮楚
朝三幕四	朝三暮四
朝庭	朝廷
朝闻道夕死可矣	朝闻道，夕死可矣
朝夷暮跖	朝夷暮
朝锺暮鼓	朝钟暮鼓
朝种暮	朝种暮获
嘲笑著	嘲笑着
嘲哳	啁哳
潮呼呼	潮乎乎
潮忽忽	潮乎乎
潮天	朝天
潮洲	潮州
吵吵嚷	吵吵嚷嚷
炒手	抄手
车把势	车把式
车箱	车厢
车载斗粮	车载斗量
扯旗放h	扯旗放炮
莨亩崞	扯鼓夺旗
彻底交待	彻底交代
彻头彻底	彻头彻尾
掣后腿	扯后腿
撤消	撤销
撤消处分	撤销处分
撤消职务	撤销职务
澈底	彻底
_目~腕	嗔目扼腕
_目结舌	瞠目结舌
尘垢z糠	尘垢秕糠
尘土飞杨	尘土飞扬
臣床	卧床
臣床不起	卧床不起
臣倒	卧倒
臣底	卧底
臣房	卧房
臣虎藏龙	卧虎藏龙
臣铺	卧铺
臣式	卧式
臣室	卧室
臣薪尝胆	卧薪尝胆
沉缅	沉湎
沉缅酒色	沉湎酒色
沉缅于	沉湎于
沉砂池	沉沙池
沉鱼落燕	沉鱼落雁
沉著痛快	沉着痛快
辰己午未	辰巳午未
陈词谰调	陈词滥调
陈词烂调	陈词滥调
陈德容	陈德蓉
陈慧姗	陈慧珊
陈加玲	陈嘉玲
陈见飞	陈剑飞
陈年旧帐	陈年旧账
陈年老帐	陈年老账
陈述原由	陈述缘由
陈帐	陈账
{踔	踔
称目结舌	瞠目结舌
称钱	趁钱
称体载衣	称体裁衣
称心满原	称心满愿
趁风使船	趁风使舵
趁风使柁	趁风使舵
趁夥打劫	趁伙打劫
趁心	称心
趁心如意	称心如意
趁心像意	称心像意
趁意	称意
铛铛	当当
撑竿跳	撑杆跳
撑竿跳高	撑杆跳高
瞠乎後已	瞠乎后已
瞠乎後矣	瞠乎后矣
瞠乎其後	瞠乎其后
瞠呼其后	瞠乎其后
瞠目洁舌	瞠目结舌
成份	成分
成份不好	成分不好
成份指数	成分指数
成气侯	成气候
成群打夥	成群打伙
成群结夥	成群结伙
成人不自在自在不成人	成人不自在，自在不成人
成事不足败事有余	成事不足，败事有余
成团打K	成团打块
成想	承想
成象	成像
成效卓着	成效卓著
成也萧何败也萧何	成也萧何，败也萧何
成也肖何	成也萧何
成荫	成阴
成语辞典	成语词典
成则为王败则为贼	成则为王，败则为贼
承前启後	承前启后
承上启后	承上启下
承上起下	承上启下
承天之v	承天之佑
承先启後	承先启后
城濠	城壕
城门立雪	程门立雪
城门失火殃及池鱼	城门失火，殃及池鱼
乘兴而来败兴而归	乘兴而来，败兴而归
乘兴而往败兴而归	乘兴而往，败兴而归
惩前毖後	惩前毖后
惩前毙后	惩前毖后
惩一警百	惩一儆百
程p理学	程朱理学
程p学派	程朱学派
程p之学	程朱之学
澄彻	澄澈
逞工f巧	逞工炫巧
逞奇眩异	逞奇炫异
秤不离铊	秤不离砣
吃工夫	吃功夫
吃里扒外	吃里爬外
吃衣著饭	着衣吃饭
吃斋佛	吃斋念佛
鸱枭	鸱^
痴男I女	痴男呆女
痴心忘想	痴心妄想
痴云I雨	痴云呆雨
螭m魍魉	螭魅魍魉
驰聘	驰骋
驰聘疆场	驰骋疆场
持强好胜	恃强好胜
持之一恒	持之以恒
持之以a	持之以恒
踟躇	踟蹰
踟躇不前	踟蹰不前
尺蚓穿堤能漂一邑	尺蚓穿堤，能漂一邑
尺有所短寸有所长	尺有所短，寸有所长
侈糜	侈靡
齿白红	齿白唇红
齿牙馀惠	齿牙余惠
齿牙馀慧	齿牙余慧
齿牙馀论	齿牙余论
耻居王後	耻居王后
叱诧风云	叱咤风云
叱吒风云	叱咤风云
赤博	赤膊
赤博上阵	赤膊上阵
赤搏	赤膊
赤搏上阵	赤膊上阵
赤	赤裸裸
充分想象	充分想像
冲破樊离	冲破樊篱
冲帐	冲账
冲值卡	充值卡
崇论宏议	崇论闳议
崇论闳论	崇论闳议
x臂拒辙	虫臂拒辙
x臂鼠肝	虫臂鼠肝
x鸣螽跃	虫鸣螽跃
x沙猿鹤	虫沙猿鹤
x书鸟迹	虫书鸟迹
x书鸟篆	虫书鸟篆
x言鸟迹	虫言鸟迹
x叶成字	虫叶成字
抽功夫	抽工夫
抽z骋妍	抽秘骋妍
抽苔	抽薹
抽象蒙	抽象朦胧
抽噎	抽咽
抽绎	r绎
绎	r绎
仇仇	仇雠
仇定	雠定
仇人相见分外眼红	仇人相见，分外眼红
绸谬	绸缪
畴类	俦类
愁躇	踌躇
愁躇满志	踌躇满志
稠缎	绸缎
稠人广座	稠人广坐
稠子	绸子
筹画	筹划
筹马	筹码
酬躇满志	踌躇满志
踌躇M志	踌躇满志
踌蹰	踌躇
臭名招著	臭名昭著
臭名昭着	臭名昭著
臭名诏著	臭名昭著
臭气薰天	臭气熏天
出锋头	出风头
出类拔粹	出类拔萃
出类拔翠	出类拔萃
出谋画策	出谋划策
出那	出纳
出奇不意	出其不意
出奇致胜	出奇制胜
出去口看	出去看看
出人意味地	出人意料的
出神入画	出神入化
出师不力	出师不利
出於意表	出于意表
出於意外	出于意外
出帐	出账
出组成	出租成
初出茅芦	初出茅庐
初来步到	初来乍到
初生犊	初生犊儿
股h	樗蒲
除恶勿尽	除恶务尽
除峄	除湿机
I	龃龉
橱师	厨师
储精蓄税	储精蓄锐
储茂	储藏
储茂室	储藏室
楚楚可观	楚楚可怜
楚天都市暴	楚天都市报
A润而雨	础润而雨
处之偌定	处之若定
处之偌素	处之若素
m傥	倜傥
触家触须	触甲触须
揣揣不安	惴惴不安
揣摸	揣摩
踹气	喘气
穿红带绿	穿红戴绿
穿流不息	川流不息
穿靴戴冒	穿靴戴帽
穿凿复会	穿凿附会
穿凿傅会	穿凿附会
穿著	穿着
穿著光鲜	穿着光鲜
传风火	传风扇火
传纪	传记
传@袭紫	传龟袭紫
船进港弯	船进港湾
骼	傅雷
喘嘘嘘	喘吁吁
串连	串联
疮巨深	疮巨衅深
床第	床笫
床第之欢	床笫之欢
床第之私	床笫之私
床缛	床褥
创记录	创纪录
创钜痛仍	创巨痛仍
创钜痛深	创巨痛深
创历史最高纪录	创历史最高记录
创新纪录	创新记录
创痍	疮痍
创痍满目	疮痍满目
创痍未寥	创痍未疗
吹棒	吹捧
吹枯拉朽	摧枯拉朽
吹毛求次	吹毛求疵
吹毛求刺	吹毛求疵
吹眠曲	催眠曲
垂诞三尺	垂涎三尺
垂首贴耳	垂首帖耳
垂死争扎	垂死挣扎
垂头翼	垂头拓翼
垂衔	垂涎
垂衔三尺	垂涎三尺
胸跌脚	捶胸跌脚
胸跌足	捶胸跌足
qx	憔悴
春暧人心	春暖人心
春蚕到死丝方尽蜡炬成灰泪始干	春蚕到死丝方尽，蜡炬成灰泪始干
春光溶溶	春光融融
春辉	春晖
春生夏长秋收冬藏	春生夏长，秋收冬藏
蝽象	椿象
淳淳告诫	谆谆告诫
敝舌腐	唇敝舌腐
齿相须	唇齿相须
齿相依	唇齿相依
辅相连	唇辅相连
腐齿落	唇腐齿落
红齿白	唇红齿白
尖舌利	唇尖舌利
焦口燥	唇焦口燥
焦舌敝	唇焦舌敝
揭齿寒	唇揭齿寒
竭齿寒	唇竭齿寒
枪舌剑	唇枪舌剑
j舌剑	唇枪舌剑
亡齿寒	唇亡齿寒
戳力同心	戮力同心
戳无路	戳无路儿
绰绰有馀	绰绰有余
绰绰有裕	绰绰有余
绰然有馀	绰然有余
绰有馀暇	绰有余暇
绰有馀裕	绰有余裕
呲牙咧咀	呲牙咧嘴
词赋	辞赋
词令	辞令
词藻	辞藻
词章	辞章
茨菰	慈姑
瓷漆	磁漆
慈详	慈祥
慈详的笑容	慈祥的笑容
辞不达意	词不达意
辞汇	词汇
辞讼	词讼
辞严义正	词严义正
辞严谊正	词严义正
磁器	瓷器
雌雄同柱	雌雄同株
@粑	糍粑
此既	此即
此系膺品	此系赝品
刺猥头	刺猬头
赐与	赐予
从末	从未
从善如登从恶如崩	从善如登，从恶如崩
从以待旦	坐以待旦
从中干旋	从中斡旋
匆猝	匆促
匆卒	匆促
聪明睿知	聪明睿智
聪明敝	聪明睿知
凑和	凑合
粗旷	粗犷
粗卤	粗鲁
粗心大义	粗心大意
猝中	卒中
酢酱草	酢浆草
子	镩子
催毁性	摧毁性
催帐单	催账单
摧促	催促
璀灿	璀璨
脆绿	翠绿
淬不及防	猝不及防
翠饶珠围	翠绕珠围
存亡齿寒	唇亡齿寒
撮科打{	撮科打哄
措词不当	措辞不当
措踪复杂	错综复杂
错采镂金	错彩镂金
错辞不当	措词不当
错手不及	措手不及
哒哒	嗒嗒
搭当	搭档
搭挡	搭档
搭拉	耷拉
搭连	褡裢
搭裢	褡裢
搭]	搭讪
褡连	褡裢
褡联	褡裢
达芬奇	达・芬奇
沓来至	沓来麇至
沓无音信	杳无音信
答碴儿	搭碴儿
答覆	答复
答理	搭理
答腔	搭腔
答讪	搭讪
打把势	打把式
打报不平	打抱不平
打拚	打拼
打补钉	打补丁
打颤	打战
打灯迷	打灯谜
打迭	打叠
打顿儿	打盹儿
打个颤	打个战
打恭作揖	打躬作揖
打躬作辑	打躬作揖
打躬做揖	打拱作揖
打拱作辑	打拱作揖
打拱作揖	打躬作揖
打b场	打谷场
打击不利	打击不力
打家劫会	打家劫舍
打家劫社	打家劫舍
打家截舍	打家劫舍
打架斗欧	打架斗殴
打磕睡	打瞌睡
打腊	打蜡
打蓝球	打篮球
打冷颤	打冷战
打量一翻	打量一番
打破纪录	打破记录
打破沙锅	打破砂锅
打手式	打手势
打予防针	打预防针
打鱼郎	打渔郎
打鱼人	打渔人
打召面儿	打照面儿
打着颤	打着战
大坂	大阪
大不例颠	大不列颠
大部份	大部分
大才榱	大才榱盘
大才	大才盘盘
大澈大悟	大彻大悟
大吹人擂	大吹大擂
大淳小庇	大醇小疵
大淳小疵	大醇小疵
大辞典	大词典
大胆想象	大胆想像
大多类同	大多雷同
大放光采	大放光彩
大放厥辞	大放厥词
大公尤私	大公无私
大喝采	大喝彩
大哄大嗡	大轰大嗡
大夥儿	大伙儿
大脚姆趾	大脚拇趾
大桔子	大橘子
大块朵颐	大快朵颐
大K文章	大块文章
大浪掏沙	大浪淘沙
大陆性气侯	大陆性气候
大茂经	大藏经
大名顶顶	大名鼎鼎
大漠孤烟直长河落日圆	大漠孤烟直，长河落日圆
大姆指	大拇指
大怒人怨	天怒人怨
大气侯	大气候
大气晚成	大器晚成
大前题	大前提
大酒	大曲酒
大D酒	大曲酒
大麴酒	大曲酒
大壤之别	天壤之别
大杀风景	大煞风景
大声急呼	大声疾呼
大事纪	大事记
大厅广众	大庭广众
大廷广众	大庭广众
大显神手	大显身手
大相迳庭	大相径庭
大相庭径	大相径庭
大漩涡	大旋涡
大学肆业	大学肄业
大檐帽	大沿帽
大义廪然	大义凛然
大有稗益	大有裨益
大有迳庭	大有径庭
大有做为	大有作为
大庾	大余
大约莫	大约摸
大展鸿图	大展宏图
大智偌愚	大智若愚
大作文章	大做文章
呆坏帐	呆坏账
呆会	待会
呆楞楞	呆愣愣
呆偌木鸡	呆若木鸡
呆帐	呆账
呆帐坏帐	呆账坏账
y头y脑	呆头呆脑
代价而估	待价而沽
迨拳道	跆拳道
带答不理	待答不理
带孝	戴孝
带罪立功	戴罪立功
待价而估	待价而沽
待迂	待遇
玳玳花	代代花
戴高帽	戴高帽儿
单式记帐	单式记账
单则易折众则难摧	单则易折，众则难摧
担白	坦白
担搁	耽搁
担搁到	耽搁到
担食壶浆	箪食壶浆
耽心	担心
耽忧	担忧
l惊受怕	担惊受怕
胆颤	胆战
胆颤心寒	胆战心寒
胆颤心惊	胆战心惊
胆大枉为	胆大妄为
胆大忘为	胆大妄为
胆大於身	胆大于身
但愿人长久千里共婵娟	但愿人长久，千里共婵娟
弹拔乐器	弹拨乐器
弹簧称	弹簧秤
弹精竭虑	殚精竭虑
弹刻	弹劾
弹刻领导	弹劾领导
弹子	弹子台
弹子抬	弹子台
惮财竭力	殚财竭力
惮精竭虑	殚精竭虑
惮精竭虚	殚精竭虑
惮思竭虑	殚思竭虑
淡薄名利	淡泊名利
淡不上	谈不上
淡汝浓抹	淡妆浓抹
淡扫蛾眉	淡扫娥眉
蛋白示	蛋白石
蛋白梯	蛋白体
澹泊	淡泊
澹泊寡欲	淡泊寡欲
澹泊明志	淡泊明志
澹泊明志，宁静致远	淡泊明志，宁静致远
澹泊明志宁静致远	澹泊明志，宁静致远
澹然	淡然
澹然处之	淡然处之
当场出采	当场出彩
当家做主	当家作主
当局者迷旁观者清	当局者迷，旁观者清
当人不让	当仁不让
当务之争	当务之急
当值无愧	当之无愧
当作财富	当做财富
当作外人	当做外人
当作笑柄	当做笑柄
当做	当作
挡面	当面
宕帐	宕账
荡检逾f	荡检逾闲
刀靶儿	刀把儿
刀光箭影	刀光剑影
刀俎馀生	刀俎余生
叨陪末坐	叨陪末座
岛霉素	稻霉素
倒绷孩	倒绷孩儿
倒挂金勾	倒挂金钩
倒冠落	倒冠落佩
倒噍	倒嚼
倒楣	倒霉
倒楣鬼	倒霉鬼
倒踏门	倒插门
倒孩	倒孩儿
倒味口	倒胃口
倒帐	倒账
捣把	倒把
捣乱份子	捣乱分子
捣腾	倒腾
捣虚撇抗	捣虚批亢
祷	祷念
蹈常故	蹈常习故
蹈故常	蹈故习常
蹈光养晦	韬光养晦
到处传颂	到处传诵
到处飘泊	到处漂泊
到时侯	到时候
到有点意思	倒有点意思
悼辞	悼词
悼悼有余	绰绰有余
盗国大盗	窃国大盗
盗跖之物	盗之物
盗锺掩耳	盗钟掩耳
道傍苦李	道旁苦李
道傍之筑	道旁之筑
道傍筑室	道旁筑室
道高一尺魔高一丈	道高一尺，魔高一丈
道高益安势高益危	道高益安，势高益危
道谦	道歉
道听涂说	道听途说
道远知骥世伪知贤	道远知骥，世伪知贤
得薄能鲜	德薄能鲜
得不尝失	得不偿失
得大独厚	得天独厚
得道多助失道寡助	得道多助，失道寡助
得高望重	德高望重
得害关系	利害关系
得厉	得利
得陇忘蜀	得陇望蜀
得人者昌失人者亡	得人者昌，失人者亡
得胜头	得胜头回
得意忘筌	得鱼忘筌
得意忘言	得意妄言
得意扬扬	得意洋洋
得鱼忘荃	得鱼忘筌
德高望众	德高望重
德克萨斯	得克萨斯
德胜头	得胜头回
的时侯	的时候
灯采	灯彩
灯迷	灯谜
灯蕊	灯芯
灯心	灯芯
灯心草	灯芯草
灯心绒	灯芯绒
登峰市	登封市
登高远跳	登高远眺
登极	登基
登帐	登账
等侯	等候
等f人家	等闲人家
等f视之	等闲视之
低徊	低回
低三下	低三下四
低头搭脑	低头耷脑
低粘度	低黏度
边	堤边
溃蚁孔	堤溃蚁孔
滴滴嗒嗒	滴滴答答
滴里耷拉	滴哩答拉
滴里嘟噜	嘀里嘟噜
滴露研p	滴露研朱
滴水不搀	滴水不羼
狄克推多	狄克维多
狄斯可	迪斯科
狄斯奈乐	迪斯尼乐园
狄斯耐乐	迪斯尼乐园
迪士高	迪斯科
迪斯科午	迪斯科舞
迪斯可	迪斯科
笛卡儿	笛卡尔
底帐	底账
抵瑕蹈隙	涤瑕蹈隙
抵帐	抵账
抵柱	砥柱
勾	抵触
龟	抵牾
地拆天崩	地坼天崩
地到	地道
地复天翻	地覆天翻
地官	地宫
地广人希	地广人稀
地旷人希	地旷人稀
地上天官	地上天宫
地五会	第五回
掂斤拨两	掂斤播两
掂念	惦念
颠簸嘴	颠唇簸嘴
颠峰	巅峰
颠复	颠覆
颠仆不破	颠扑不破
颠朴不破	颠扑不破
颠衣到裳	颠衣倒裳
扑不破	颠扑不破
典藉	典籍
典茂	典藏
点拔	点拨
电灯炮	电灯泡
电饭褒	电饭煲
电吉它	电吉他
电闪雷呜	电闪雷鸣
电子称	电子秤
白	念白
有词	念念有词
佛	念佛
经	念经
来去	念来念去
起来	念起来
书	念书
下去	念下去
一	念一念
珠	念珠
刁钻促	刁钻促掏
凋蔽	凋敝
虫小技	雕虫小技
虫篆刻	雕虫篆刻
x小技	雕虫小技
x篆刻	雕虫篆刻
肝琢肾	雕肝琢肾
章镂句	雕章镂句
雕敝	凋敝
雕弊	凋敝
雕虫小计	雕虫小技
雕x薄技	雕虫薄技
雕x刻篆	雕虫刻篆
雕x末伎	雕虫末伎
雕x末技	雕虫末技
雕x小技	雕虫小技
雕x小巧	雕虫小巧
雕x小事	雕虫小事
雕x小艺	雕虫小艺
雕x篆刻	雕虫篆刻
雕粱画栋	雕梁画栋
雕零	凋零
雕落	凋落
雕象	雕像
雕谢	凋谢
吊儿锒铛	吊儿郎当
吊尔郎当	吊儿郎当
吊卷	调卷
吊以轻心	掉以轻心
调拔	调拨
调兵谴将	调兵遣将
调兵遗将	调兵遣将
调弄舌	调唇弄舌
调仃调仃	调停调停
调坎儿	调侃儿
调嗓子	吊嗓子
调舌弄	调舌弄唇
调神城	调神畅情
调味汗	调味汁
调遗	调遣
调以轻心	掉以轻心
调p傅粉	调朱傅粉
调p弄粉	调朱弄粉
跌荡	跌宕
跌荡不羁	跌宕不羁
跌荡不拘	跌宕不拘
跌荡放言	跌宕放言
跌荡风流	跌宕风流
跌荡起伏	跌宕起伏
跌交	跌跤
跌脚胸	跌脚捶胸
迭床架屋	叠床架屋
迭翠	叠翠
迭迭不休	喋喋不休
迭放	叠放
迭罗汉	叠罗汉
迭印	叠印
迭韵	叠韵
迭嶂	叠嶂
血	喋血
谍碟不休	喋喋不休
牒血	喋血
牒血街头	喋血街头
蝶舞蜂暄	蝶舞蜂喧
蹀血	喋血
l离鹣背	鲽离鹣背
丁冬	丁东
丁咀铁舌	钉嘴铁舌
丁宁	叮咛
丁宁戒告	叮咛告诫
丁是丁卯是卯	丁是丁，卯是卯
丁嘱丁嘱	叮嘱叮嘱
仃辛伫苦	停辛伫苦
仃滞不前	停滞不前
叮当声	丁当声
叮	丁当
叮档	丁当
玎当	丁当
钉木椿	钉木桩
钉钮扣	钉纽扣
钉梢	盯梢
钉是钉铆是铆	钉是钉，铆是铆
顶顶大名	鼎鼎大名
顶锋	顶峰
顶瓜瓜	顶呱呱
顶刮刮	顶呱呱
顶礼摩拜	顶礼膜拜
顶帐	顶账
鼎立相助	鼎力相助
鼎食鸣锺	鼎食鸣钟
鼎鱼幕蒸	鼎鱼幕燕
定单	订单
定户	订户
定婚	订婚
定货	订货
定货单	订货单
定率	定律
定期会悟	定期会晤
定阅	订阅
丢三拉四	丢三落四
东北东	北东东
东边日头西边雨	东边日出西边雨
东不拉	冬不拉
东瓜	冬瓜
东麟西爪	东鳞西爪
东南东	南东东
东ξ	东ξ鞒
东一句西	东一句，西一句
东一句西一句	东一句，西一句
东隅已逝桑榆非晚	东隅已逝，桑榆非晚
冬冬声	咚咚声
冬寒抱冰夏热握火	冬寒抱冰，夏热握火
动人心肺	动人心弦
动若观火	洞若观火
动辙	动辄
动辙得咎	动辄得咎
冻结帐号	冻结账号
洞洞々	洞洞
洞见肺俯	洞见肺腑
洞偌观火	洞若观火
洞萧横吹	洞箫横吹
都市计画	都市计划
斗合舌	斗唇合舌
斗美F丽	斗美夸丽
斗欧	斗殴
斗趣儿	逗趣儿
抖嘴	斗嘴
拱	斗拱
	斗拱
逗遛	逗留
毒夫民贼	独夫民贼
毒赋敛	毒赋剩敛
读书扎记	读书札记
读万卷书行万里路	读万卷书，行万里路
独出新裁	独出心裁
独此一家别无分店	独此一家，别无分店
独挡一面	独当一面
独家报导	独家报道
独善其养	独善其身
独树一枝	独树一帜
独行其要	独行其是
独在异乡为异客每逢佳节倍思亲	独在异乡为异客，每逢佳节倍思亲
独占螯头	独占鳌头
独占头	独占鳌头
独占头	独占鳌头
赌波集团	赌博集团
赌帐	赌账
妒贤忌能	妒贤嫉能
杜蘅	杜衡
杜渐防荫	杜渐防萌
度长e大	度长洁大
度长e短	度长洁短
度过难关	渡过难关
度江	渡江
渡过暑假	度过暑假
渡过这段时光	度过这段时光
渡假	度假
渡假村	度假村
渡假区	度假区
渡假胜地	度假胜地
渡蜜月	度蜜月
渡日	度日
渡日如年	度日如年
镀铬纲	镀铬钢
端五	端午
端五节	端午节
端祥	端详
端佯	端详
短小精干	短小精悍
短小精捍	短小精悍
断壁残桓	断壁残垣
断壁颓桓	断壁颓垣
断管残c	断管残渖
断齑K粥	断齑块粥
断章取意	断章取义
断纸馀墨	断纸余墨
锻练	锻炼
堆迭	堆叠
堆集如山	堆积如山
队伍宠大	队伍庞大
对薄公堂	对簿公堂
对窗夜雨	对床夜雨
对号入坐	对号入座
对流性雨	对流星雨
对像	对象
对於	对于
对帐	对账
对证下药	对症下药
对症下	对症下药
兑帐	兑账
顿学累功	钝学累功
顿足胸	顿足捶胸
遁辞	遁词
多采多姿	多彩多姿
多多包含	多多包涵
多咀多舌	多嘴多舌
多明哥	多明戈
多明尼加	多米尼加
多麽	多么
多水份的	多水分的
多姿多采	多姿多彩
咄拙逼人	咄咄逼人
哆唆	哆嗦
掇句成文	缀句成文
躲茂	躲藏
俄克拉何马州	俄克拉荷马州
俄勒岗	俄勒冈
峨嵋派	峨眉派
峨嵋山市	峨眉山市
鹅銮鼻	鹅鸾鼻
蛾度F行	蛾度蛇行
蛾冠博带	峨冠博带
蛾眉大眼	娥眉大眼
蛾眉皓齿	娥眉皓齿
蛾眉皓首	娥眉皓首
蛾眉曼F	娥眉曼F
蛾眉螓首	娥眉螓首
蛾眉月	娥眉月
额首称庆	额手称庆
扼吭夺食	扼亢夺食
扼吭拊背	扼亢拊背
扼坑拊背	扼亢拊背
恶贯潢盈	恶贯满盈
恶耗	噩耗
恶很很	恶狠狠
恶虎扑食	饿虎扑食
恶化顷向	恶化倾向
恶言漫骂	恶言谩骂
恶意咀咒	恶意诅咒
恶意挑拔	恶意挑拨
恶紫夺p	恶紫夺朱
饿虎朴食	饿虎扑食
饿死事小失节事大	饿死事小，失节事大
遏渐防荫	遏渐防萌
~臂啮指	扼臂啮指
恩断意绝	恩断义绝
尔虞我炸	尔虞我诈
耳鬓斯磨	耳鬓厮磨
耳根清静	耳根清净
耳掴子	耳刮子
耳後风生	耳后风生
耳聋眼\	耳聋眼黑
耳儒目染	耳濡目染
耳熟能祥	耳熟能详
耳闻是虚眼观为实	耳闻是虚，眼观为实
耳详能熟	耳熟能详
二佛涅	二佛涅盘
二缶锺惑	二缶钟惑
二虎相斗必有一伤	二虎相斗，必有一伤
二簧	二黄
二人同心其利断金	二人同心，其利断金
二氧化炭	二氧化碳
贰心	二心
发场光大	发扬光大
发出卡嗒声	发出咔哒声
发奋图强	发愤图强
发奋忘食	发愤忘食
发愤努力	发奋努力
发愤有为	发奋有为
发广	发光
发楞	发愣
发令抢	发令枪
发振聩	发蒙振聩
发人深醒	发人深省
发韧	发轫
发生磨擦	发生摩擦
发眩光	发炫光
发扬光人	发扬光大
发扬广大	发扬光大
发音宏亮	发音洪亮
发指毗裂	发指眦裂
发自肺脏	发自肺腑
发踪指示	发纵指示
乏乏之辈	泛泛之辈
乏指	泛指
法不殉情	法不徇情
法考福	法兰克福
法朗	法郎
法律面前人人平等	法律面前，人人平等
法律之前人人平等	法律之前，人人平等
法挺	法庭
法网恢恢疏而不漏	法网恢恢，疏而不漏
法属圭亚	法属圭亚那
珐质	珐琅质
翻常	反常
翻弄舌	翻唇弄舌
翻复	翻覆
翻复无常	反复无常
翻簧	翻黄
翻旧帐	翻旧账
翻来复去	翻来覆去
翻老帐	翻老账
翻然	幡然
翻然改进	幡然改进
翻然改图	幡然改图
翻然悔悟	幡然悔悟
翻然醒悟	幡然醒悟
翻手为云覆手为雨	翻手为云，覆手为雨
翻天复地	翻天覆地
翻箱倒	翻箱倒柜
翻云复雨	翻云覆雨
藩茄	番茄
藩然	幡然
藩然醒悟	幡然醒悟
x黄倒o	翻黄倒皂
凡蒂冈	梵蒂冈
凡事预则立不预则废	凡事预则立，不预则废
烦难	繁难
烦脑	烦恼
烦杂	繁杂
烦燥	烦躁
烦燥不安	烦躁不安
烦燥情绪	烦躁情绪
蕃茄	番茄
蕃茄炒蛋	番茄炒蛋
蕃茄酱	番茄酱
蕃茄片	番茄片
蕃茄沙司	番茄沙司
蕃衍	繁衍
燔书l儒	燔书坑儒
繁华锦锈	繁华锦绣
繁琐哲学	烦琐哲学
繁文褥节	繁文缛节
反唇相机	反唇相讥
反唇相稽	反唇相讥
反相讥	反唇相讥
反相稽	反唇相讥
反动份子	反动分子
反复筹画	反复筹划
反复蕴酿	反复酝酿
反覆	反复
反覆地说	反复地说
反覆地做	反复地做
反覆无常	反复无常
反革命分	反革命分子
反革命份	反革命分子
反工自问	反躬自问
反弓自问	反躬自问
反还	返还
反老还童	返老还童
反璞归真	返璞归真
反应锐敏	反应敏锐
反应意见	反映意见
反云覆雨	翻云覆雨
反殖	繁殖
返本还原	返本还源
返顾	反顾
返祖现像	返祖现象
犯言直谏	犯颜直谏
浩摩苍	泛浩摩苍
滥成灾	泛滥成灾
应曲当	泛应曲当
宅浮家	泛宅浮家
饭囊酒Y	饭囊酒瓮
贩夫俗子	凡夫俗子
贩夫o隶	贩夫皂隶
梵地冈	梵蒂冈
梵谛冈	梵蒂冈
方柄	方枘
方柄圆凿	方枘圆凿
方纳园凿	方枘圆凿
方枘园凿	方枘圆凿
方枘圜凿	方枘圆凿
方兴未爱	方兴未艾
方以类聚物以群分	方以类聚，物以群分
方针、政策	方针政策
芳兰竞体	芳兰竟体
防碍	妨碍
防碍交通	妨碍交通
防不胜放	防不胜防
防化学兵	防化兵
防民之口甚于防川	防民之口，甚于防川
防署降温	防暑降温
防微堵渐	防微杜渐
防微杜惭	防微杜渐
防微杜	防微杜衅
防制	仿制
妨患未然	防患未然
妨微堵渐	防微杜渐
妨微杜渐	防微杜渐
彷佛	仿佛
彷	仿佛
纺垂体	纺锤体
纺垂形	纺锤形
	仿佛
放刁撤泼	放刁撒泼
放空档	放空挡
放下屠刀立地成佛	放下屠刀，立地成佛
放象机	放像机
放言遣辞	放言遣词
放影	放映
放帐	放账
放诸四海皆准	放诸四海而皆准
飞刍n粒	飞刍挽粒
飞刍n粮	飞刍挽粮
飞刍n粟	飞刍挽粟
飞短流长	蜚短流长
飞粮n秣	飞粮挽秣
飞流直下三千尺疑是银河落九天	飞流直下三千尺，疑是银河落九天
飞砂走石	飞沙走石
飞扬拔户	飞扬跋扈
飞扬拔扈	飞扬跋扈
飞r	飞扬
飞^	飞扬
飞语	蜚语
飞云制电	飞云掣电
非常畅顺	非常顺畅
非常光采	非常光彩
非常松驰	非常松弛
非刺不可	非此不可
非短流长	飞短流长
非肥o	非肥皂
非不可	非你不可
非莫属	非你莫属
非营利	非赢利
非营业收	非营业收入
非营业支	非营业支出
非州之角	非洲之角
肥q鸣高	肥遁鸣高
肥o粉	肥皂粉
匪薄	菲薄
斐红色	绯红色
废驰	废弛
废气肿	肺气肿
废钱	费钱
肺府	肺腑
费舌	费唇舌
费功夫	费工夫
费品率	废品率
分拔	分拨
分崩离兮	分崩离析
分辩率	分辨率
分道扬镖	分道扬镳
分付	吩咐
分毫析	分毫析厘
分户帐	分户账
分类帐	分类账
分毫丝	分厘毫丝
分内分外	份内份外
分庭亢礼	分庭抗礼
分外事	份外事
分文不直	分文不值
分帐	分账
纷烦	纷繁
纷纭扰嚷	纷纭扰攘
纷至踏来	纷至沓来
纷致沓来	纷至沓来
围	氛围
焚林而田竭泽而渔	焚林而田，竭泽而渔
粉骨粉身	粉骨分身
粉面p	粉面朱唇
粉未	粉末
粉装玉琢	粉妆玉琢
份内分外	份内份外
奋勇拚搏	奋勇拼搏
忿忿	愤愤
忿忿不平	愤愤不平
忿恨	愤恨
忿怒	愤怒
忿怒地	愤怒地
忿然	愤然
愤笔疾书	奋笔疾书
愤不顾身	奋不顾身
愤发	奋发
愤发图强	奋发图强
愤世疾俗	愤世嫉俗
粪便学	粪便
粪土当年万户候	粪土当年万户侯
丰采	风采
丰度翩翩	风度翩翩
丰富多采	丰富多彩
丰富想象	丰富想像
丰功伟迹	丰功伟绩
丰墙下	丰墙硗下
丰墙峭n	丰墙峭址
丰收在忘	丰收在望
丰谀	丰腴
丰谀之地	丰腴之地
丰韵	风韵
丰姿	风姿
风{水宿	风餐水宿
风餐路宿	风餐露宿
风尘仆扑	风尘仆仆
风尘扑扑	风尘仆仆
风弛电掣	风驰电掣
风档	风挡
风档刮水器	风挡刮水器
风档雨雪刷	风挡雨雪刷
风高放火月黑杀人	风高放火，月黑杀人
风和日	风和日暖
风火连天	烽火连天
风雷火h	风雷火炮
风流酝藉	风流蕴藉
风流藉	风流蕴藉
风流d藉	风流酝藉
风毛麟角	凤毛麟角
风糜	风靡
风糜一时	风靡一时
风魔	疯魔
风起云踊	风起云涌
风声鹤泪	风声鹤唳
风声鹤立	风声鹤唳
风声鹤唳草木皆兵	风声鹤唳，草木皆兵
风岵	风湿病
风嵝	风湿性
风宿水{	风宿水餐
风雨飘u	风雨飘摇
风雨如诲	风雨如晦
风云变换	风云变幻
风中之浊	风中之烛
风姿卓约	风姿绰约
风恣绰约	风姿绰约
封妻J子	封妻荫子
封g蛇	封g修蛇
疯颠	疯癫
疯癫颠	疯颠颠
疯疯颠颠	疯疯癫癫
疯瘫	风瘫
峰颠	峰巅
峰功伟绩	丰功伟绩
峰火	烽火
锋芒必露	锋芒毕露
锋	锋芒
锋毕露	锋芒毕露
蜂扇聚	蜂扇蚁聚
蜂屯聚	蜂屯蚁聚
蜂涌	蜂拥
蜂涌而上	蜂拥而上
逢勃	蓬勃
逢勃的绿	蓬勃的绿
逢场做戏	逢场作戏
讽剌地	讽刺地
凤毛鳞角	凤毛麟角
凤午龙飞	凤舞龙飞
奉命唯瑾	奉命唯谨
佛劳伦斯人	佛罗伦萨人
佛洛伊德	弗洛伊德
佛洛依德	弗洛伊德
佛洛依德派	佛洛伊德派
佛是金妆人是衣妆	佛是金妆，人是衣妆
佛头著粪	佛头着粪
佛象	佛像
否极太来	否极泰来
夫倡妇随	夫唱妇随
肤见识	肤见谫识
肤皮潦草	浮皮潦草
肤受之	肤受之诉
~县	富县
敷衍瑛责	敷衍塞责
敷演	敷衍
敷演塞责	敷衍塞责
弗赖堡	弗莱堡
弗洛依德	弗洛伊德
伏辩	服辩
伏侍	服侍
伏首称臣	俯首称臣
伏输	服输
扶箕	扶乩
拂光掠影	浮光掠影
拂罗里达	佛罗里达
拂罗伦萨	佛罗伦萨
服低做小	伏低做小
服服贴贴	服服帖帖
服事	服侍
服饰都丽	服饰华丽
服贴	服帖
服贴听命	服帖听命
俘掳	俘虏
俘游类	浮游类
氟里昂	氟利昂
浮瓜沈李	浮瓜沉李
浮石沈木	浮石沉木
浮图	浮屠
浮想连篇	浮想联翩
浮想联篇	浮想联翩
浮游选矿	浮法选矿
浮燥	浮躁
幅射	辐射
幅射线	辐射线
幅原	幅员
幅原辽阔	幅员辽阔
福不重至祸必重来	福不重至，祸必重来
福份	福分
福孙J子	福孙荫子
福兮祸所伏祸兮福所倚	福兮祸所伏，祸兮福所倚
辐凑	辐辏
抚背扼喉	拊背扼喉
抚掌大笑	拊掌大笑
抚掌击节	拊掌击节
府第	府邸
拊背~吭	拊背扼亢
俯臣	俯卧
俯臣撑	俯卧撑
俯拾既是	俯拾皆是
俯首贴耳	俯首帖耳
釜底抽新	釜底抽薪
辅车齿	辅车唇齿
腐化坠落	腐化堕落
腐植土	腐殖土
腐植质	腐殖质
簋不	簋不修
付研究员	副研究员
付艺伟	傅艺伟
付帐	付账
付总指挥	副总指挥
妇儒皆知	妇孺皆知
负手就擒	俯首就擒
负	负隅
负吠缈	负隅顽抗
负重含@	负重含污
负作用	副作用
附合	附和
附著	附着
附赘悬U	附赘悬疣
复被	覆被
复巢无完卵	覆巢无完卵
复盖	覆盖
复盖面	覆盖面
复没	覆没
复灭	覆灭
复盆之冤	覆盆之冤
复盆子	覆盆子
复水难收	覆水难收
复亡	覆亡
复习考	复习考试
复循环往	循环往复
复责任	负责任
复辙	覆辙
副甲状线	副甲状腺
傅粉施p	傅粉施朱
傅会	附会
傅利叶	傅立叶
富国兵	富国强兵
富丽堂黄	富丽堂皇
富丽堂煌	富丽堂皇
富商大贵	富商大贾
富于想象	富于想像
富於春秋	富于春秋
赋与	赋予
赋与精神	赋予精神
赋与肉体	赋予肉体
缚舌交	缚舌交唇
建省	福建省
蝮蛇螫手壮士解腕	蝮蛇螫手，壮士解腕
覆核	复核
覆前戒後	覆前戒后
覆审	复审
覆文	复文
覆信	复信
覆议	复议
伽里略	伽利略
V子	嘎子
该博	赅博
该守不逾	恪守不渝
该帐	该账
改大换地	改天换地
改弦更章	改弦更张
改弦易章	改弦易张
盖头换面	改头换面
盖子于	盖子
概叹	慨叹
干变万化	千变万化
干坤	乾坤
干旋	斡旋
干与	干预
干躁	干燥
甘败下风	甘拜下风
甘比亚共和国	冈比亚共和国
甘篮菜	甘蓝菜
甘冒不讳	甘冒不韪
甘心情原	甘心情愿
甘心如养	甘心如荠
甘之吠饴	甘之如饴
甘之如怡	甘之如饴
杆头直上	竿头直上
敢作敢为	敢做敢为
感到希奇	感到稀奇
感极涕零	感激涕零
感举	盛举
感觉道	感觉到
感觉锐敏	感觉敏锐
感情融恰	感情融洽
感人肺府	感人肺腑
感谢辞	感谢词
感兴起	感兴趣
s尽杀绝	赶尽杀绝
擀面仗	擀面杖
指钢蛊	干父之蛊
刚风	罡风
刚腹	刚愎
刚腹自用	刚愎自用
纲纪废驰	纲纪废弛
钢a儿	钢G儿
钢愎自用	刚愎自用
钢筋混泥土	钢筋混凝土
钢柔并济	刚柔并济
钢铁混凝土	钢筋混凝土
港弯	港湾
高不低不就	高不凑低不就
高不云衢	高步云衢
高材生	高才生
高长	高涨
高潮叠起	高潮迭起
高度凝炼	高度凝练
高官厚录	高官厚禄
高利货	高利贷
高梁	高粱
高梁酒	高粱酒
高梁米	高粱米
高粮	高粱
高粱杆子	高粱秆子
高粱竿子	高粱杆子
高粱子弟	膏粱子弟
高朋满坐	高朋满座
高抬明镜	高台明镜
高谈弘论	高谈宏论
高统靴	高筒靴
高薪技术	高新技术
高瞻远属	高瞻远瞩
高瞻远嘱	高瞻远瞩
高掌远跖	高掌远
高着	高招
高着儿	高招儿
膏场绣	膏场绣浍
膏唇岐舌	膏唇歧舌
膏贩舌	膏唇贩舌
膏岐舌	膏唇歧舌
膏拭舌	膏唇拭舌
膏梁	膏粱
膏梁锦绣	膏粱锦绣
膏梁锦锈	膏粱锦锈
膏梁纨绔	膏粱纨绔
膏梁纨F	膏粱纨绔
膏梁子弟	膏粱子弟
膏粱纨F	膏粱纨绔
告别辞	告别词
告戒	告诫
戈巴契夫	戈尔巴乔夫
圪立	屹立
圪塔	圪
纥J	疙瘩
疙疸	疙瘩
哥们意气	哥们义气
哥斯达尼加	哥斯达黎加
歌台午榭	歌台舞榭
歌台舞谢	歌台舞榭
歌午升平	歌舞升平
歌舞N平	歌舞升平
革奸暴	革奸铲暴
革命尚未成功诸君尚需努力	革命尚未成功，诸君尚需努力
格登	咯噔
格杀无论	格杀勿论
格於成例	格于成例
隔裂之感	割裂之感
隔年黄历	隔年皇历
扇	隔扇
个人帐户	个人账户
各人所得税	个人所得税
各人自扫门前雪莫管他人瓦上霜	各人自扫门前雪，莫管他人瓦上霜
各色名样	各色各样
各抒已见	各抒己见
各舒己见	各抒己见
各述己见	各抒己见
各行其事	各行其是
各自为正	各自为政
w中人	个中人
给与	给予
给与精力	给予精力
给与名称	给予名称
根柢	根底
根结盘据	根结盘踞
根据互	根据盘互
根深底固	根深蒂固
根深柢固	根深蒂固
根深帝固	根深蒂固
跟部	根部
更待乾罢	更待干罢
更章	更张
羹藜i糗	羹藜含糗
耿耿於怀	耿耿于怀
耿耿於心	耿耿于心
耿值	耿直
梗咽	哽咽
梗直	耿直
鲠直	耿直
工程峻工	工程竣工
工夫不负有心人	功夫不负有心人
工夫茶	功夫茶
工民	公民
工续	工读
工欲善其事必先利其器	工欲善其事，必先利其器
公尔忘私	公而忘私
公伤事故	工伤事故
公说公有理婆说婆有理	公说公有理，婆说婆有理
功败锤成	功败垂成
功迹	功绩
功亏一匮	功亏一篑
功亏一溃	功亏一篑
功亏一蒉	功亏一篑
功其一点	攻其一点
功心为止	攻心为上
攻城掠地	攻城略地
攻其一点不及其余	攻其一点，不及其余
攻无不取战无不胜	攻无不取，战无不胜
攻心扼吭	攻心扼亢
供不於求	供不应求
供献巨大	贡献巨大
宫庭	宫廷
恭逢其盛	躬逢其盛
恭贺新喜	恭贺新禧
恭侯	恭候
恭唯	恭维
恭惟	恭维
巩仪县	巩义市
共度难关	共渡难关
共轭象	共轭像
共商国事	共商国是
共为齿	共为唇齿
共襄感举	共襄盛举
勾划	勾画
勾稽	钩稽
勾阑	勾栏
勾联	勾连
勾深致远	钩深致远
勾针	钩针
佝瘘病	佝偻病
沟造	构造
钩勒	勾勒
钩勒出	勾勒出
钩玄猎z	钩玄猎秘
狗咀里吐不出象牙	狗嘴里吐不出象牙
狗荀蝇营	狗苟蝇营
苟合取容	苟合取安
苟廷残喘	苟延残喘
构置	购置
够戗	够呛
k陷	构陷
估恶不俊	怙恶不悛
估名钓誉	沽名钓誉
咕叽	咕唧
姑父	姑夫
姑负	辜负
姑负好意	辜负好意
姑忘言之	姑妄言之
孤独矜寡	孤独鳏寡
孤汗迅	孤儿寡妇
孤负	辜负
孤苦伶丁	孤苦伶仃
孤苦零丁	孤苦伶仃
孤伶伶	孤零零
孤另另	孤零零
孤癖	孤僻
孤身漂零	孤身飘零
孤掌难明	孤掌难鸣
孤柱一掷	孤注一掷
沽名钩誉	沽名钓誉
轱轳	轱辘
毂辘	轱辘
鹘仑吞枣	囫囵吞枣
古道循肠	古道热肠
古惑	蛊惑
古楼区	鼓楼区
古时侯	古时候
古式钮扣	古式纽扣
古稳	古筝
古希之年	古稀之年
古丈	古文
谷碌碌	骨碌碌
股分	股份
骨董	古董
骨瘦如豺	骨瘦如柴
鼓弄舌	鼓唇弄舌
鼓摇舌	鼓唇摇舌
鼓咋舌	鼓唇咋舌
鼓惑	蛊惑
鼓惑人心	蛊惑人心
鼓舌扬	鼓舌扬唇
鼓舌摇	鼓舌摇唇
鼓午鼓午	鼓舞鼓舞
鼓舞欢忻	鼓舞欢欣
鼓躁	鼓噪
鼓躁而进	鼓噪而进
Y父蚕母	谷父蚕母
Y贱伤农	谷贱伤农
Y马砺兵	谷马砺兵
固步自封	故步自封
固持己见	固执己见
固定脂	固定值
固疾	痼疾
固态复萌	故态复萌
固习	痼习
固执已见	固执己见
故技	故伎
故技重演	故伎重演
故名思义	顾名思义
故弄弦虚	故弄玄虚
故影自怜	顾影自怜
故作矜恃	故作矜持
故作恣态	故作姿态
故做高深	故作高深
故做神秘	故作神秘
顾後瞻前	顾后瞻前
顾名思议	顾名思义
顾名思意	顾名思义
顾意	故意
雇用军	雇佣军
锢疾	痼疾
瓜瓜声	呱呱声
瓜田不纳履李下不整冠	瓜田不纳履，李下不整冠
刮搭板儿	呱嗒板儿
刮刮叫	呱呱叫
刮噪	聒噪
刮噪不休	聒噪不休
W起来	刮起来
呱哒	呱嗒
呱呱堕地	呱呱坠地
寡廉鲜止	寡廉鲜耻
挂帐	挂账
G误	诖误
乖蜜舌	乖唇蜜舌
拐弯末角	拐弯抹角
拐仗	拐杖
怪癖任性	怪僻任性
关不料	关不了
关仃并转	关停并转
关东出相关西出将	关东出相，关西出将
关怀倍至	关怀备至
关健	关键
关键时侯	关键时刻
关连	关联
关连性	关联性
关门养虎虎大伤人	关门养虎，虎大伤人
关於	关于
观查	观察
观点倾侧	观点倾向
观模	观摩
观模教学	观摩教学
观磨	观摩
观磨教学	观摩教学
观畔而动	观衅而动
观畔伺隙	观衅伺隙
观伺隙	观衅伺隙
官棵穹	官逼民反
官冕堂皇	冠冕堂皇
官请法正	官清法正
冠振海	阏窈
鳏寡孤	鳏寡孤茕
鳏寡亩	鳏寡茕独
馆茂	馆藏
管到	管道
管理条理	管理条例
管秃焦	管秃唇焦
管帐	管账
贯例	惯例
贯输	灌输
贯输知识	灌输知识
灌迷汤	灌米汤
光采	光彩
光采夺目	光彩夺目
光采照人	光彩照人
光大化日	光天化日
光风霏月	光风霁月
光怪路离	光怪陆离
光化度	光滑度
光化性	光滑性
光前绝後	光前绝后
光前启後	光前启后
光前裕後	光前裕后
光阴在苒	光阴荏苒
广茅	广袤
广茅无垠	广袤无垠
归根结柢	归根结底
归根结帝	归根结底
归国华侨联合	归国华侨联合会
归师勿掩穷寇勿追	归师勿掩，穷寇勿追
归依我佛	皈依我佛
归於	归于
归真反璞	归真返璞
龟毛免角	龟毛兔角
龟寿遐铃	龟寿遐龄
规规矩距	规规矩矩
规规距距	规规矩矩
规画	规划
规戒	规诫
规距	规矩
规距仪	规矩仪
瑰伟	瑰玮
鬼崇	鬼祟
鬼斧伸	鬼斧神工
鬼斧神功	鬼斧神工
鬼鬼崇崇	鬼鬼祟祟
鬼鬼祟崇	鬼鬼祟祟
鬼计	诡计
鬼计百端	诡计百端
鬼计多端	诡计多端
鬼哭狼嗥	鬼哭狼嚎
鬼哭神号	鬼哭神嚎
鬼秘	诡秘
鬼域伎俩	鬼蜮伎俩
鬼蜮技俩	鬼蜮伎俩
鬼r	鬼蜮
鬼吒狼嚎	鬼咤狼嚎
贵而贱目	贵耳贱目
K竹	桂竹
滚瓜溜园	滚瓜溜圆
滚滚波滔	滚滚波涛
滚珠承轴制造厂	滚珠轴承制造厂
滚柱轴承	滚珠轴承
聒躁	聒噪
国不转睛	目不转睛
国防科学技术工业委员	国防科学技术工业委员会
国计民	国计民生
国际互连网	国际互联网
国际像棋	国际象棋
国际形式	国际形势
国家中医院管理局	国家中医药管理局
国空一切	目空一切
国库卷	国库券
国民身分证	国民身份证
果焰糕点	果馅糕点
果于自信	过于自信
过都历K	过都历块
过度时期	过渡时期
过份	过分
过份夸赞	过分夸赞
过份眩耀	过分炫耀
过街老鼠人人喊打	过街老鼠，人人喊打
过景	过境
过甚其词	过甚其辞
过尤不及	过犹不及
过于繁琐	过于烦琐
过於	过于
过	过载
过帐	过账
哈叭狗	哈巴狗
哈吧狗	哈巴狗
哈儿滨工大	哈尔滨工大
哈蟆	蛤蟆
哈蟆镜	蛤蟆镜
海拨	海拔
海参威	海参崴
海关总暑	海关总署
海军陆战	海军陆战队
海哩	海里
海洛英	海洛因
海棉	海绵
海棉状	海绵状
海内存知己天涯若比邻	海内存知己，天涯若比邻
海内存知已，天涯若比邻	海内存知己，天涯若比邻
海内澹然	海内淡然
海市唇楼	海市蜃楼
海弯	海湾
海宴河清	海晏河清
海枣	海藻
海澡类	海藻类
海蛰	海蜇
骇怕	害怕
害起时腋	害起肘腋
酣沉芾	酣畅淋漓
酣歌a舞	酣歌恒舞
憨态可鞠	憨态可掬
含冰茹	含冰茹檗
含垢纳@	含垢纳污
含胡	含糊
含糊其词	含糊其辞
含@忍垢	含污忍垢
含辛如苦	含辛茹苦
含血人	含血e人
含饴弃孙	含饴弄孙
函梏关	函谷关
涵蓄	含蓄
涵义	含义
寒伧	寒碜
寒颤	寒战
寒颤颤	寒战战
寒禁	寒噤
寒喧	寒暄
寒喧客套	寒暄客套
韩卢逐[	韩卢逐逡
韩G逐K	韩G逐块
韩信将兵多多益善	韩信将兵，多多益善
汉高解	汉高解佩
汉姆雷特	哈姆雷特
汉牛充栋	汗牛充栋
I格不入	擀格不入
I格不通	擀格不通
汗流夹背	汗流浃背
汗N儿	汗儿
旱马	汗马
旱马功劳	汗马功劳
捍将	悍将
焊n	焊J
憾动	撼动
航天飞船	航天飞机
毫不晦言	毫不讳言
毫千里	毫厘千里
毫丝忽	毫厘丝忽
毫无二志	毫无二致
毫无顾及	毫无顾忌
毫无疑	毫无疑问
毫州市	亳州市
嗥哭	嚎哭
豪不	毫不
豪厘	毫厘
豪厘不伐，将用斧柯	毫厘不伐，将用斧柯
豪厘不爽	毫厘不爽
豪硬环ィ将用斧柯	毫厘不伐，将用斧柯
嚎G	号啕
嚎G大哭	号啕大哭
嚎啕大哭	号啕大哭
濠梁之上	壕梁之上
濠濮间想	壕濮间想
好把	好吧
好吃懒作	好吃懒做
好高务远	好高骛远
好高鹜远	好高骛远
好工夫	好功夫
好级了	好极了
好家夥	好家伙
好酒不怕巷水深	好酒不怕巷子深
好来坞	好莱坞
好人难作	好人难做
好人喜功	好大喜功
好事不出门恶事行千里	好事不出门，恶事行千里
好事多a	好事多悭
好事天a	好事天悭
好务	好恶
好象	好像
好象是	好像是
好行小慧	好行小惠
好逸务劳	好逸恶劳
号寒啼讥	号寒啼饥
号如烟海	浩如烟海
号G	号啕
号G大哭	号啕大哭
号淘大哭	号啕大哭
浩翰	浩瀚
浩淼	浩渺
皓齿蛾眉	皓齿娥眉
皓齿红	皓齿红唇
皓齿p	皓齿朱唇
呵叱	呵斥
呵腰	哈腰
B野\山	喝野\山
喝采	喝彩
喝倒采	喝倒彩
喝得泥醉	喝得烂醉
合壁	合璧
合壁连珠	合璧连珠
合格人材	合格人才
合夥人	合伙人
合	
合盘托出	和盘托出
合式地	合适地
合我其谁	舍我其谁
合谐	和谐
合衣而睡	和衣而睡
合衷共济	和衷共济
合舟共济	和衷共济
何患无辞	何患无词
何以解忧，惟有杜康	何以解忧，唯有杜康
何足挂赤	何足挂齿
和霭	和蔼
和霭可亲	和蔼可亲
和浦珠还	合浦珠还
和事老	和事佬
和阗	和田
和协	和谐
和颜说色	和颜悦色
河叉	河汊
河涸海乾	河涸海干
河漏	
河落海乾	河落海干
核打出	核打击
核对帐目	核对账目
核下	垓下
荷泽市	菏泽市
涸思乾虑	涸思干虑
涸泽而渔焚林而猎	涸泽而渔，焚林而猎
阖家欢	合家欢
贺辞	贺词
贺尔蒙	荷尔蒙
赫磁共振	核磁共振
赫尔新基	赫尔辛基
赫鲁雪夫	赫鲁晓夫
黑不溜	黑不溜秋
黑灯下火	黑灯瞎火
黑咕笼咚	黑咕隆咚
黑古龙冬	黑咕隆咚
黑鼓隆咚	黑咕隆咚
黑忽忽	黑乎乎
黑龙谭	黑龙潭
黑钮扣	黑纽扣
黑鸦鸦	黑压压
黑幽幽	黑黝黝
黑帐	黑账
黑脂麻	黑芝麻
很难想象	很难想像
很在灵气	很有灵气
横臣	横卧
横档	横挡
横度	横渡
横度长江	横渡长江
横隔膜	横膈膜
横看成岭侧成峰远近高低各不同	横看成岭侧成峰，远近高低各不同
横征暴a	横征暴敛
横徵暴赋	横征暴赋
横徵暴敛	横征暴敛
横徵苛役	横征苛役
横座标	横坐标
轰轰烈烈后头	轰轰烈烈
轰堂大笑	哄堂大笑
轰笑	哄笑
哄动	轰动
哄动全国	轰动全国
哄动一时	轰动一时
烘云月	烘云托月
弘论	宏论
弘图	宏图
弘愿	宏愿
弘旨	宏旨
红高梁	红高粱
红儿	红果儿
红兰铅笔	红蓝铅笔
红通通	红彤彤
红通通的	红彤彤的
红焰焰	红艳艳
红紫夺p	红紫夺朱
红紫乱末	红紫乱朱
红紫乱p	红紫乱朱
宏都拉斯	洪都拉斯
宏亮	洪亮
宏篇巨制	鸿篇巨制
宏扬	弘扬
鸿断鱼沈	鸿断鱼沉
鸿福	洪福
鸿福齐天	洪福齐天
鸿函钜椟	鸿函巨椟
鸿渐於干	鸿渐于干
鸿	鸿蒙
鸿篇钜制	鸿篇巨制
鸿图	宏图
鸿图大展	宏图大展
鸿图华构	宏图华构
鸿章钜字	鸿章巨字
{堂大笑	哄堂大笑
侯补	候补
侯补委员	候补委员
侯车	候车
侯车室	候车室
侯方	候方
侯机	候机
侯机楼	候机楼
侯她	候她
侯你	候你
侯鸟	候鸟
侯审	候审
侯他	候他
侯我	候我
侯选	候选
侯选人	候选人
后脖梗	后脖颈
后车站	候车站
后脑杓	后脑勺
后座力	后坐力
後发制人	后发制人
後顾之忧	后顾之忧
後海先河	后海先河
後喝	后喝
後悔地	后悔地
後悔无及	后悔无及
後会有期	后会有期
後继有人	后继有人
後进领袖	后进领袖
後进之秀	后进之秀
後来地	后来地
後来居上	后来居上
後来之秀	后来之秀
後面的	后面的
後起之秀	后起之秀
後生可畏	后生可畏
後生小子	后生小子
後台老板	后台老板
後拥前呼	后拥前呼
候服玉食	侯服玉食
候马市	侯马市
候门	侯门
候门如海	侯门如海
候王将相	侯王将相
候耀华	侯耀华
呼吃	呼哧
呼蚩	呼哧
呼嗤	呼哧
呼风换雨	呼风唤雨
呼喇	呼啦
呼天a地	呼天龠地
呼玄喝六	呼幺喝六
忽如一夜春风来千树万树梨花开	忽如一夜春风来，千树万树梨花开
唿扇	呼扇
唿哨	呼哨
胡臭	狐臭
胡蝶	蝴蝶
胡肥锺瘦	胡肥钟瘦
胡里胡涂	糊里糊涂
胡芦巴	葫芦巴
胡罗卜	胡萝卜
胡萝匐	胡萝卜
胡弄胡弄	糊弄糊弄
胡涂	糊涂
胡做非为	胡作非为
斛筹交错	觥筹交错
湖吃海喝	胡吃海喝
糊辣汤	胡辣汤
糊涂帐	糊涂账
kh	胡同
b口	糊口
虎居龙盘	虎踞龙盘
虎倨龙盘	虎踞龙盘
虎据龙盘	虎踞龙盘
虎距龙盘	虎踞龙盘
虎踞龙蟠	虎踞龙盘
虎口馀生	虎口余生
虎落平	虎落平川
虎魄	琥珀
虎视眈耽	虎视眈眈
虎视耽耽	虎视眈眈
虎咽狼{	虎咽狼餐
虎掷龙	虎掷龙拿
互邦互助	互帮互助
互古	亘古
互古未有	亘古未有
互连网	互联网
互相推委	互相推诿
户枢不蠢	户枢不蠹
护避	护庇
怙恶不俊	怙恶不悛
花冈石	花岗石
花冈岩	花岗岩
花好月四	花好月圆
花好月园	花好月圆
花狸狐哨	花里胡哨
花里胡梢	花里胡哨
花梢	花哨
花稍	花哨
花消	花销
花帐	花账
花着	花招
华尔滋	华尔兹
华盛顿邮	华盛顿邮报
华众取宠	哗众取宠
哗拉	哗啦
哗喇喇	哗啦啦
滑杆	滑竿
化费	花费
化学反映	化学反应
化妆舞会	化装舞会
化装服	化妆服
化装品	化妆品
化子	花子
划拔	划拨
划地为牢	画地为牢
划地自限	画地自限
划帐	划账
画饼允叽	画饼充饥
画布绷架	画布棚架
画策	划策
画策设谋	划策设谋
画地力牢	画地为牢
画分为	划分为
画蛇填足	画蛇添足
画蛇著足	画蛇着足
画时代	划时代
画象	画像
话碴儿	话茬儿
怀壁其罪	怀璧其罪
怀才不迂	怀才不遇
怀刑自爱	怀刑自受
徊肠伤气	回肠荡气
坏帐	坏账
欢渡	欢度
欢渡春节	欢度春节
欢渡国庆	欢度国庆
欢心鼓舞	欢欣鼓舞
欢忻鼓舞	欢欣鼓舞
欢忻踊跃	欢欣踊跃
欢欣鼓午	欢欣鼓舞
欢迎辞	欢迎词
租砉奈	欢忭鼓舞
仔霉奈	欢欣鼓舞
还淳反扑	还淳反朴
还年s老	还年却老
还是由不	还是由于
还帐	还账
环宇	寰宇
唤档	换挡
换档	换挡
换然一新	焕然一新
涣然一新	焕然一新
焕难	患难
焕散	涣散
o然冰释	涣然冰释
荒缪绝伦	荒谬绝伦
荒信儿	谎信儿
皇皇不可终日	惶惶不可终日
黄柏	黄檗
黄骠毛	黄骠马
黄橙橙的	黄澄澄的
黄发撼	黄发儿齿
黄发T背	黄发鲐背
黄河摊	黄河滩
黄花冈	黄花岗
黄花岗七十二烈	黄花岗七十二烈士
黄花岗七十二烈士	黄花冈七十二烈士
黄口小	黄口小儿
黄烂烂	黄灿灿
黄历	皇历
黄梁美梦	黄粱美梦
黄梁梦	黄粱梦
黄梁一梦	黄粱一梦
黄埔江	黄浦江
黄色录相	黄色录像
黄帐	黄账
黄钟毁弃瓦釜雷鸣	黄钟毁弃，瓦釜雷鸣
黄锺毁弃	黄钟毁弃
黄锺瓦缶	黄钟瓦缶
惶惶不可	惶惶不可终日
遑遑不可	惶惶不可终日
遑遑不可终日	惶惶不可终日
恍忽	恍惚
恍恍忽忽	恍恍惚惚
晃然大悟	恍然大悟
晃如隔世	恍如隔世
谎谬	荒谬
谎谬绝伦	荒谬绝伦
谎张	慌张
幌惚	恍惚
灰	灰蒙蒙
恢i怪	恢诡谲怪
恢宏	恢弘
恢恢有馀	恢恢有余
恢气	灰气
恢谐	诙谐
恢心	灰心
恢心丧气	灰心丧气
挥金璞玉	浑金璞玉
挥汁如雨	挥汗如雨
晖映	辉映
辉皇	辉煌
回肠结气	回肠荡气
回覆	回复
回光反照	回光返照
回互	回护
回棋	悔棋
回乾就湿	回干就湿
回山倒海	排山倒海
回游	洄游
悔人不倦	诲人不倦
汇聚	会聚
会逢其m	会逢其适
会集	汇集
会计帐	会计账
会谈记要	会谈纪要
会悟	会晤
会议记要	会议纪要
会帐	会账
讳谟如深	讳莫如深
讳寞如深	讳莫如深
绘事後素	绘事后素
烩炙人口	脍炙人口
彗锘涂	彗泛画涂
_锘涂	彗泛画涂
昏迷不省	昏迷不醒
荤粥	獯鬻
浑沌	混沌
浑浑沌沌	混混沌沌
浑浑沈沈	浑浑沉沉
浑抡吞枣	囫囵吞枣
浑沦吞枣	囫囵吞枣
浑洒自如	挥洒自如
魂不负体	魂不附体
魂不赴体	魂不附体
魂不著体	魂不着体
魂飞魄r	魂飞魄扬
魂b色沮	魂慑色沮
诨诨噩噩	浑浑噩噩
诨然一体	浑然一体
混吉	混迹
混球儿	浑球儿
混然天成	浑然天成
混然一体	浑然一体
混身	浑身
混身解数	浑身解数
混身是胆	浑身是胆
混水摸鱼	浑水摸鱼
混淆世听	混淆视听
混帐	混账
混帐东西	混账东西
混帐话	混账话
混浊	浑浊
溷浊	浑浊
豁达人度	豁达大度
豁拳	划拳
豁然省悟	豁然醒悟
活动份子	活动分子
活象	活像
活性碳	活性炭
火伴	伙伴
火暴	火爆
火夫	伙夫
火侯	火候
火化塞	火花塞
火煤	火媒
火山融岩	火山熔岩
火炎山	火焰山
火中取粟	火中取栗
夥伴	伙伴
夥计	伙计
获益匪浅	获益非浅
祸发肖墙	祸发萧墙
祸国秧民	祸国殃民
祸起肖墙	祸起萧墙
祸兮福所倚福兮祸所伏	祸兮福所倚，福兮祸所伏
霍邱县	霍丘县
击鞭m镫	击鞭锤镫
叽哩咕噜	叽里咕噜
饥{渴饮	饥餐渴饮
饥肠碌碌	饥肠辘辘
饥附饱r	饥附饱扬
饥笑	讥笑
饥者易为食渴者易为饮	饥者易为食，渴者易为饮
机不可失，时不可来	机不可失，时不再来
机不可失失不再来	机不可失，失不再来
机伶	机灵
机率	几率
肌肠碌碌	饥肠辘辘
芨芨可危	岌岌可危
鸡x得丧	鸡虫得丧
鸡x得失	鸡虫得失
鸡旦里挑骨头	鸡蛋里挑骨头
鸡旦里找骨头	鸡蛋里挑骨头
鸡飞旦打	鸡飞蛋打
鸡毛谧	鸡毛掸子
鸡犬N天	鸡犬升天
鸡犬之声相闻老死不相往来	鸡犬之声相闻，老死不相往来
唧咕	叽咕
唧唧嘎嘎	叽叽嘎嘎
唧唧咕咕	叽叽咕咕
唧唧喳喳	叽叽喳喳
积财千万不如薄技在身	积财千万，不如薄技在身
积德裕後	积德裕后
积非贯	积非习贯
积Y防饥	积谷防饥
积毁消骨	积毁销骨
积极份子	积极分子
积日t久	积日累久
积善馀庆	积善余庆
积思广义	集思广益
积土为山积水为海	积土为山，积水为海
积生常	积习生常
积畜	积蓄
积液成裘	积腋成裘
积腋成裘	集腋成裘
积重难反	积重难返
基层检察关	基层检察机关
基金帐户	基金账户
绩突出	成绩突出
犄角之势	掎角之势
缉征股	稽征股
畸开发展	畸形发展
畸零	奇零
畸型	畸形
稽察员	稽查员
激忿	激愤
激忿填膺	激愤填膺
激进份子	激进分子
激流勇退	急流勇退
激烛扬清	激浊扬清
激浊杨清	激浊扬清
V恨	赍恨
V赏	赍赏
及时报导	及时报道
吉米卡特	吉米・卡特
汲汲皇皇	汲汲遑遑
即然	既然
即然如此	既然如此
即生瑜，何生亮	既生瑜，何生亮
即往	既往
即往不究	既往不咎
即以其人之道还治其人之身	即以其人之道，还治其人之身
即早	及早
极力沮遏	极力阻遏
极深研	极深研几
极重不反	积重不返
极重难返	积重难返
急公近利	急功近利
急功尽利	急功近利
急火功心	急火攻心
急进份子	激进分子
急来报佛脚	急来抱佛脚
急敛暴徵	急敛暴征
急流漩涡	急流旋涡
急人这急	急人之急
急於求成	急于求成
急於星火	急于星火
急燥	急躁
疾恶如雠	疾恶如仇
疾恶若雠	嫉恶若仇
疾风暴雨	急风暴雨
疾首辊	疾首颦蹙
疾贤妒能	嫉贤妒能
集少成多	积少成多
集思广义	集思广益
集思广议	集思广益
集液成裘	集腋成裘
嫉贪如雠	嫉贪如仇
蒺k	蒺藜
辑逸	辑佚
籍口	借口
几年纪	几年级
己能	已能
己所不欲勿施于人	己所不欲，勿施于人
挤挤一堂	济济一堂
挤身	跻身
挤身于	跻身于
脊地	瘠地
掎裳连袂	掎裳联袂
掎裳联袂	掎裳连袂
计不返顾	计不反顾
计成	计程
计划慎密	计划缜密
计画	计划
计日成功	计日程功
计算机体层成象	计算机体层成像
计无返顾	计无反顾
记不请	记不清
记程车	计程车
记分牌	计分牌
记记帐	记记账
记录片	纪录片
记录片儿	纪录片儿
记念	纪念
记事薄	记事簿
记数器	计数器
记要	纪要
记忆忧新	记忆犹新
记忆尤新	记忆犹新
记帐	记账
记帐联	记账联
记帐员	记账员
纪纲人论	纪纲人伦
纪纲松驰	纪纲松弛
纪录下来	记录下来
纪律焕散	纪律涣散
纪律松驰	纪律松弛
纪之交	世纪之交
技俩	伎俩
技能亢进	机能亢进
技人员	技术人员
季风气侯	季风气候
既如	即如
既使	即使
既使如此	即使如此
既往不纠	既往不咎
既往不究	既往不咎
既有今日何必当初	既有今日，何必当初
觊揄	觊觎
觊揄非分	觊觎非分
寄花献佛	借花献佛
寄与	寄予
加尔格达	加尔各达
加格达齐	加格达奇
加官进爵	加官晋爵
加利略	伽利略
加太基	迦太基
加油战	加油站
夹心饼乾	夹心饼干
夹肢窝	胳肢窝
佳宾	嘉宾
佳宾满座	嘉宾满座
佳砑迅	佳儿佳妇
迦西亚	加西亚
家长礼短	家长里短
家常里短	家长里短
家祭无忘告乃翁	家祭毋忘告乃翁
家俱	家具
家有弊帚享之千金	家有弊帚，享之千金
家喻户	家喻户习
家寓户晓	家喻户晓
砘	家伙
砭	家具
硎	家什
h	家h
葭县	佳县
嘉偶	佳偶
嘉偶天成	佳偶天成
戛釜撞Y	戛釜撞瓮
驾式	架势
驾御	驾驭
架海金	架海金梁
架式	架势
假力於人	假力于人
假人假义	假仁假义
假相	假象
假帐	假账
嫁鸡随鸡嫁狗随狗	嫁鸡随鸡，嫁狗随狗
嫁妆企业	家装企业
嫁装	嫁妆
奸滑	奸猾
奸离	间离
奸同鬼蜮行若狐鼠	奸同鬼蜮，行若狐鼠
尖咀薄舌	尖嘴薄舌
尖咀猴腮	尖嘴猴腮
尖沙咀	尖沙嘴
坚持不榭	坚持不懈
坚定不疑	坚定不移
坚苦奋斗	艰苦奋斗
坚苦卓越	艰苦卓绝
坚困	艰困
坚难	艰难
坚难地	艰难地
坚难困苦	艰难困苦
坚韧不拔	坚忍不拔
坚如盘石	坚如磐石
坚守自盗	监守自盗
坚信不移	坚信不疑
坚贞不逾	坚贞不渝
歼殊途同归	殊途同归
间文	闲文
肩磨踵接	肩摩踵接
艰钜	艰巨
艰苦磨练	艰苦磨炼
艰苦扑素	艰苦朴素
兼包并畜	兼包并蓄
兼收并畜	兼收并蓄
兼听则明偏听则暗	兼听则明，偏听则暗
兼听则明偏信则暗	兼听则明，偏信则暗
兼p重紫	兼朱重紫
监察官	检察官
监澧县	监利县
菅窥蠡测	管窥蠡测
菅弦乐队	管弦乐队
煎	煎饼
捡了芝麻丢了西瓜	捡了芝麻，丢了西瓜
减省	俭省
减省得	俭省得
剪指夹	剪指甲
检玻器	检波器
检查长	检察长
检查官	检察官
检查署	检察署
检肃	检索
趼子	茧子
硷金属	碱金属
硷熔	碱熔
硷石灰	碱石灰
硷土金属	碱土金属
硷性	碱性
简爱	简・爱
简接	间接
简介性	简洁性
简炼	简练
翦草除根	剪草除根
见不容发	间不容发
见风驶舵	见风使舵
见几而作	见机而作
见利思议	见利思义
见貌辨色	鉴貌辨色
见仁见志	见仁见智
见微受命	见危授命
见微知箸	见微知著
见微知着	见微知著
见小大	见小暗大
见义思迁	见异思迁
见之不取思之千里	见之不取，思之千里
建帐	建账
建帐备查	建账备查
剑拔驽张	剑拔弩张
剑拔努张	剑拔弩张
f不容发	间不容发
f不容缓	间不容缓
f不容砺	间不容砺
f不容缕	间不容缕
f不容i	间不容i
f不容息	间不容息
f曹冷局	闲曹冷局
f非f是	闲非闲是
f花覆	闲花野草
f花野草	闲花野草
f见层出	间见层出
f鸥野鹭	闲鸥野鹭
f情别致	闲情别致
f情逸趣	闲情逸趣
f情逸志	闲情逸志
f情逸致	闲情逸致
f神野鬼	闲神野鬼
f是f非	闲是闲非
f言长语	闲言长语
f言淡语	闲言淡语
f言f语	闲言闲语
f言冷语	闲言冷语
f言泼语	闲言泼语
f言碎语	闲言碎语
f言赘语	闲言赘语
f云孤鹤	闲云孤鹤
f云野鹤	闲云野鹤
鉴前毖後	鉴前毖后
鉴於	鉴于
键步如飞	健步如飞
箭拔努张	剑拔弩张
江山好改秉性难移	江山好改，秉性难移
江山易改，秉性难移	江山易改，禀性难移
江山易改本性难移	江山易改，本性难移
江山易改秉性难移	江山易改，秉性难移
江山易改禀性难移	江山易改，禀性难移
江水融融	江水溶溶
姜太公钓鱼愿者上钩	姜太公钓鱼，愿者上钩
将机就机	将计就计
将家皇朝	蒋家皇朝
将军抽	将军抽车
将军抽e	将军抽车
将水搅混	将水搅浑
将心相从	降心相从
将欲取之必先与之	将欲取之，必先与之
将在外君命有所不受	将在外，君命有所不受
僵旗息鼓	偃旗息鼓
村丛书	疆村丛书
村老人评词	疆村老人评词
讲议	讲义
降妞	犟妞
降紫	绛紫
交代罪行	交待罪行
交溶	交融
交帐	交账
姣姣者	佼佼者
姣媚	娇媚
娇健无比	矫健无比
娇娇二气	娇骄二气
娇娇之气	娇骄之气
娇柔造作	矫揉造作
娇揉造作	矫揉造作
娇揉造作的	矫揉造作的
娇奢淫逸	骄奢淫逸
娇正发音	矫正发音
骄儿I女	骄儿呆女
骄候I女	骄儿呆女
骄奢淫佚	骄奢淫逸
骄生惯养	娇生惯养
骄燥	骄躁
胶卷合	胶卷盒
胶著地	胶着地
焦敝舌	焦唇敝舌
焦乾肺	焦唇干肺
焦乾舌	焦唇干舌
焦心热中	焦心热衷
焦燥	焦躁
蕉萃	憔悴
鹘鹆魇	焦金流石
鹘鹚甘	焦金烁石
魍防枚	焦头烂额
角不点地	脚不点地
挢[过正	矫枉过正
挢揉造作	矫揉造作
狡滑	狡猾
狡滑的人	狡猾的人
狡免三窟	狡兔三窟
狡兔死良狗烹	狡兔死，良狗烹
皎皎者	佼佼者
皎阳似火	骄阳似火
矫憨	娇憨
矫[过正	矫枉过正
矫柔造作	矫揉造作
矫柔造作的	矫揉造作的
矫柔造作者	矫揉造作者
矫揉造做	矫揉造作
矫往过正	矫枉过正
脚登子	脚蹬子
脚根	脚跟
脚门	角门
脚色	角色
脚鸭子	脚丫子
脚指	脚趾
脚指甲	脚趾甲
脚指头	脚趾头
剿袭	抄袭
	侥幸
徼	侥幸
缴白卷	交白卷
缴出来	交出来
缴出去	交出去
缴过来	交过来
缴过去	交过去
叫化	教化
叫化子	叫花子
叫真	较真
叫真儿	较真儿
较长e短	较长洁短
较场	校场
较短e长	较短洁长
教妇初来教儿婴孩	教妇初来，教儿婴孩
教料书	教科书
醮水	蘸水
皆人欢喜	皆大欢喜
接长补短	截长补短
接特性地	接待性地
接踪	接踵
接踪而来	接踵而来
秸杆	秸秆
揭杆	揭竿
揭杆而起	揭竿而起
揭开迷底	揭开谜底
劫後馀生	劫后余生
杰出人材	杰出人才
诘屈x`	佶屈x确
诘屈聱牙	佶屈聱牙
拮倨	拮据
洁白无暇	洁白无瑕
结采	结彩
结过婚每	结过婚没
结婚证儿	结婚证
结跏	结痂
结款了帐	结款了账
结绳纪事	结绳记事
结馀	结余
结帐	结账
结帐后离开	结账后离开
	婕妤
桀傲不驯	桀骜不驯
桀骜不训	桀骜不驯
捷克和斯洛伐克	捷克斯洛伐克
捷克斯洛	捷克斯洛伐克
截发vX	截发锉X
截尽	竭尽
截尽全力	竭尽全力
截力	竭力
截趾m履	截趾适履
竭见	谒见
竭泽而鱼	竭泽而渔
解开钮扣	解开纽扣
解严令	戒严令
解衣磅	解衣盘磅
戒告	告诫
戒娇戒燥	戒骄戒躁
戒骄戒燥	戒骄戒躁
诫律	戒律
诫条	戒条
借帐	借账
藉口	借口
藉助	借助
今蝉蜕壳	金蝉脱壳
今非夕比	今非昔比
今世近视尽是近视	今世近视，尽是近视
今事昨非	今是昨非
金榜提名	金榜题名
金壁辉皇	金壁辉煌
金壁辉煌	金碧辉煌
金璧辉煌	金碧辉煌
金利莱	金利来
金銮店	金銮殿
金门诱户	金门绣户
金殴	金瓯
金殴无缺	金瓯无缺
金无赤足，人无完人	金无足赤，人无完人
金无足赤人无完人	金无足赤，人无完人
金无足金，人无完人	金无足赤，人无完人
金象	金像
金玉其外败絮其中	金玉其外，败絮其中
津津计较	斤斤计较
矜恃	矜持
筋皮力竭	筋疲力尽
筋疲力竭	筋疲力尽
襟怀担白	襟怀坦白
锦秀	锦绣
锦秀前程	锦绣前程
锦衣纨裤	锦衣纨绔
尽人事听天命	尽人事，听天命
近於	近于
近在飓尺	近在咫尺
近朱者赤近墨者黑	近朱者赤，近墨者黑
进迟两难之境	进退两难之境
进道若m	进道若蜷
进德业	进德修业
进口商装	进口商品
进身之阶	晋身之阶
进思尽忠退思补过	进思尽忠，退思补过
B多B少	尽多尽少
|绅	缙绅
禁暴珠乱	禁暴诛乱
禁若寒蝉	噤若寒蝉
噤口陨	噤口卷舌
京儿味	京味儿
京泸	京沪
经常帐户	经常账户
经付	经传
经济成份	经济成分
经济人	经纪人
经情直遂	径情直遂
经纬分明	泾渭分明
经一事长一智	经一事，长一智
经已习惯	已经习惯
经营惨澹	经营惨淡
惊风四症八侯	惊风四症八候
惊荒失措	惊惶失措
惊慌失错	惊惶失措
惊惶	惊慌
惊惶不安	惊慌不安
惊惶失措	惊慌失措
惊惶失色	惊慌失色
惊惶万状	惊慌万状
惊惶无措	惊慌无措
惊觉到	警觉到
惊心悼胆	惊心掉胆
惊心眩目	惊心炫目
菁华	精华
菁英	精英
兢竞业业	兢兢业业
精采	精彩
精采的	精彩的
精采绝伦	精彩绝伦
精采文章	精彩文章
精采文字	精彩文字
精采秀发	精彩秀发
精采演出	精彩演出
精采演讲	精彩演讲
精诚所加金石为开	精诚所至，金石为开
精诚所至金石为开	精诚所至，金石为开
精萃	精粹
精典	经典
精减	精简
精减机构	精简机构
精明能	精明能干
精明强	精明强干
精疲力尽	精疲力竭
精疲力尽地	精疲力竭地
精神涣发	精神焕发
精神焕散	精神涣散
精神恍忽	精神恍惚
精神攫铄	精神矍铄
精神委靡	精神萎靡
精神萎顿	精神委顿
井底虾蟆	井底蛤蟆
井岗山	井冈山
景冈山	景岗山
景宁余族自治县	景宁畲族自治县
景物蒙	景物朦胧
景像	景象
警房	警方
警省	警醒
警心涤滤	斋心涤虑
迳寄	径寄
迳庭	径庭
迳行	径行
迳自	径自
胫大於股	胫大于股
痉孪	痉挛
竞把	竟把
竞被	竟被
竞成	竟成
竞达	竟达
竞对	竟对
竞敢	竟敢
竞会	竟会
竞将	竟将
竞竞业业	兢兢业业
竞连	竟连
竞能	竟能
竞然	竟然
竞然会	竟然会
竞然是	竟然是
竞然有	竟然有
竞是	竟是
竞为	竟为
竞要	竟要
竞也	竟也
竞有	竟有
竞在	竟在
竞至	竟至
竞自	竟自
竞自离去	竟自离去
竟标	竞标
竟技场	竞技场
竟赛	竞赛
竟争	竞争
敬老慈a	敬老慈稚
敬事後食	敬事后食
境象	镜像
境像	景象
静侯	静候
静磨擦	静摩擦
静如处女动如脱兔	静如处女，动如脱兔
镜象	镜像
纠集凤池	鸠集凤池
纠纠	赳赳
纠纠武夫	赳赳武夫
究竞	究竟
究竞是	究竟是
究竞是谁	究竟是谁
究竞有	究竟有
究竞在	究竟在
究竞怎样	究竟怎样
鸠合	纠合
鸠集	纠集
鸠占雀巢	鸠占鹊巢
鸠兹党	鸠占鹊巢
赳纠武夫	赳赳武夫
九炼成钢	久炼成钢
九五至尊	九五之尊
九宵	九霄
九宵云外	九霄云外
九族文化村	民族文化村
久病必瘀	久病必淤
久经不衰	经久不衰
久经不息	经久不息
灸烤	炙烤
灸热	炙热
灸手可热	炙手可热
酒巴	酒吧
酒巴间	酒吧间
酒后茶馀	酒后茶余
酒後茶馀	酒后茶余
酒食徵逐	酒食征逐
酒Y饭囊	酒瓮饭囊
酒馀茶后	酒余茶后
酒馀茶後	酒余茶后
酒中渗水	酒中掺水
酒钟	酒盅
旧的不去新的不来	旧的不去，新的不来
旧恨新仇	旧恨新愁
旧帐	旧账
救正偏颇	纠正偏颇
就象	就像
就象后来	就像后来
就象外面	就像外面
就序	就绪
就坐	就座
居民身分证	居民身份证
居为己有	据为己有
鞠躬尽悴	鞠躬尽瘁
鞠躬尽萃	鞠躬尽瘁
鞠躬尽瘁死而后已	鞠躬尽瘁，死而后已
鞠躬尽粹	鞠躬尽瘁
局	R
局不安	R不安
I促	局促
桔红色	橘红色
桔黄	橘黄
桔黄色	橘黄色
桔黄色的	橘黄色的
桔树	橘树
桔子水	橘子水
桔子汁	橘子汁
R促	局促
R促不安	局促不安
R地a天	R地龠天
咀快心直	嘴快心直
咀直心快	嘴直心快
咀咒	诅咒
沮击	狙击
举步为艰	举步维艰
举如鸿毛取如拾遗	举如鸿毛，取如拾遗
举丧	沮丧
举世振惊	举世震惊
举世注目	举世瞩目
举头望明月低头思故乡	举头望明月，低头思故乡
举行晏会	举行宴会
举一返三	举一反三
举止安祥	举止安详
句式杂揉	句式杂糅
具奸	巨奸
钜大	巨大
钜额	巨额
钜款	巨款
钜人长德	巨人长德
钜学鸿生	巨学鸿生
俱奸	巨奸
倨促	局促
倨屈聱牙	佶屈聱牙
剧烈磨擦	剧烈摩擦
聚乙稀	聚乙烯
聚蚁成雷	聚蚊成雷
踞傲	倨傲
踞傲自大	倨傲自大
捐驱	捐躯
捐身徇义	捐身殉义
涓涓不壅终为江河	涓涓不壅，终为江河
镌永	隽永
卷入漩涡	卷入旋涡
卷上重来	卷土重来
卷士重来	卷土重来
倦恋	眷恋
倦眼朦胧	倦眼蒙
倦眼	倦眼蒙
噘着小嘴	撅着小嘴
噘嘴	撅嘴
薅顿足	撅耳顿足
薅挠腮	撅耳挠腮
薅揉腮	撅耳揉腮
决别	诀别
决对	绝对
决对服从	绝对服从
决了食言	决不食言
决无仅有	绝无仅有
决择	抉择
决溃痈	决痪溃痈
抉瑕摘	抉瑕摘衅
绝代隹人	绝代佳人
绝对秩	绝对值
绝後光前	绝后光前
绝後空前	绝后空前
绝妙好词	绝妙好辞
绝隹	绝佳
绝着	绝招
崛强	倔强
掘强	倔强
嚼|床	嚼腭捶床
攫铄	矍铄
军地两用人材	军地两用人才
军纪松驰	军纪松弛
军事部暑	军事部署
军事训炼	军事训练
君子一言快马一鞭	君子一言，快马一鞭
君子一言驷马难追	君子一言，驷马难追
集蜂萃	麇集蜂萃
峻工	竣工
峻宇墙	峻宇雕墙
F县	浚县
卡搭声	喀哒声
卡搭作响	喀嗒作响
卡嗒声	喀哒声
卡秋莎	喀秋莎
卡萨布兰加	卡萨布兰卡
开城布公	开诚布公
开大辟地	开天辟地
开档裤	开裆裤
开放商	开发商
开户帐号	开户账号
开华结果	开花结果
开郎	开朗
开门楫盗	开门揖盗
开门捐盗	开门揖盗
开劈者	开辟者
开消	开销
开沅节流	开源节流
开源截流	开源节流
开帐	开账
恺撒	凯撒
唾成珠	咳唾成珠
刊误表	勘误表
堪查	勘查
堪察	勘察
堪验	勘验
坎尔井	坎儿井
坎培拉	堪培拉
砍大山	侃大山
删之蛙	坎井之蛙
看碧成p	看碧成朱
看来好象	看来好像
看起来很象	看起来很像
看起来象	看起来像
看p成碧	看朱成碧
看做	看作
瑕伺隙	瞰瑕伺隙
康乃狄克州	康涅狄格州
慷慨给与	慷慨给予
慷慨激扬	慷慨激昂
考夫卡	卡夫卡
考古家	考古学家
靠著地	靠着地
坷拉	坷垃
柯林伍德	科林伍德
柯罗拉多	科罗拉多
柯罗拉多州	科罗拉多州
柯萨科夫	科萨科夫
珂王罗版	珂罗版
科技日技	科技日报
科学子析	科学分析
棵粒	颗粒
棵粒归仓	颗粒归仓
磕睡	瞌睡
髁导斜度	髁道斜度
可操胜卷	可操胜券
可穿著	可穿着
可等不急了	可等不及了
可观规律	客观规律
可观上	客观上
可见一般	可见一斑
可滤过的	可过滤的
可仑坡	科伦坡
可伦坡	科伦坡
可然性	可燃性
可想象的	可想像的
可以想象	可以想像
可做篮本	可做蓝本
渴睡	瞌睡
克丁克卯	可丁可卯
克尽夫道	克尽妇道
克苦	刻苦
克苦耐劳	刻苦耐劳
克拉马依	克拉玛依
克来德曼	克莱德曼
克里姆林	克里姆林宫
克罗蒂亚	克罗地亚
克守不渝	恪守不渝
克已奉公	克己奉公
刻苦磨炼	刻苦磨练
刻期	克期
刻日	克日
刻丝	缂丝
w己奉公	克己奉公
w期	克期
客隆	克隆
客隆羊	克隆羊
嗑睡	瞌睡
肯得基	肯德基
肯切	恳切
垦复	垦覆
恳綮	肯綮
吭害	坑害
吭害好人	坑害好人
吭人	坑人
坑坑凹凹	坑坑洼洼
空	空蒙
空蒙雨夜	空饔暌
空前绝後	空前绝后
孔席不适	孔席不周
孔席不㈣	孔席不适
恐布	恐怖
恐怖份子	恐怖分子
恐後争先	恐后争先
恐	恐吓
恐前	空前
恐前绝后	空前绝后
控拆	控诉
口齿怜俐	口齿伶俐
口腹蜜剑	口蜜腹剑
口干舌躁	口干舌燥
口密腹剑	口蜜腹剑
口密腹箭	口蜜腹剑
口乾舌焦	口干舌焦
口乾舌燥	口干舌燥
口偌悬河	口若悬河
口血未乾	口血未干
口喻	口谕
口燥乾	口燥唇干
叩人心弦	扣人心弦
扣板机	扣扳机
扣盘扪a	扣盘扪龠
扣扪a	扣盘扪龠
扣扪烛	扣盘扪烛
扣人心悬	扣人心弦
扣屎盔子	扣屎盆子
@起来	扣起来
@上来	扣上来
@上去	扣上去
@下来	扣下来
@下去	扣下去
枯骨之馀	枯骨之余
枯树生华	枯树生花
枯朽之馀	枯朽之余
苦过黄莲	苦过黄连
苦海无边回头是岸	苦海无边，回头是岸
苦思瞑想	苦思冥想
苦心孤旨	苦心孤诣
裤档	裤裆
夸大其辞	夸大其词
夸夸奇谈	夸夸其谈
跨掉	垮掉
跨下之辱	胯下之辱
快快不乐	快快乐乐
快言历色	快言厉色
宽敞了亮	宽敞明亮
宽洪大度	宽宏大度
宽洪大量	宽宏大量
宽洪海量	宽宏海量
宽恕赎	宽恕
狂朋s友	狂朋怪友
狂燥	狂躁
旷若发	旷若发蒙
矿茂	矿藏
矿物局	矿务局
葵瓜子	葵花籽
葵花子	葵花籽
脓	溃脓
	昆仑
麻	蓖麻
捉箪食	壶浆箪食
困兽尤斗	困兽犹斗
括不知耻	恬不知耻
阔老	阔佬
垃圾桶	垃圾筒
拉抵价格	拉低价格
拉丁美州	拉丁美洲
拉圾箱	垃圾箱
拉据战	拉锯战
拉拉不下脸	拉不下脸
拉拉蛄	||蛄
拉托维亚	拉脱维亚
拉帐	拉账
啦呱儿	拉呱儿
啦啦队长	拉拉队长
啦啦队员	拉拉队员
喇喇蛄	||蛄
剌剌不休	刺刺不休
腊鼓频传	腊鼓频催
腊黄	蜡黄
蜡梅	腊梅
蜡梅盛开	腊梅盛开
蜡象	蜡像
辣呼呼	辣乎乎
辣手难办	棘手难办
F	瘌痢
来福抢	来福枪
来龙去脉搏	来龙去脉
来士敬悉	来函敬悉
来者不善善者不来	来者不善，善者不来
来作	来做
莱因河	莱茵河
赖索托	莱索托
赖索托王国	莱索托王国
赖帐	赖账
癞痢	瘌痢
兰宝石	蓝宝石
兰领工人	蓝领工人
兰球	篮球
兰球比赛	篮球比赛
兰天白云	蓝天白云
兰天野	蓝天野
兰田美玉	蓝田美玉
兰熏桂馥	兰薰桂馥
拦干	栏杆
栏干	栏杆
蓝缕	褴褛
蓝球	篮球
蓝球比赛	篮球比赛
蓝球队	篮球队
蓝球健将	篮球健将
篮本	蓝本
篮队	蓝队
烂调	滥调
烂缕	褴褛
烂褛	褴褛
烂缦	烂漫
烂熳	烂漫
烂熳天真	烂漫天真
烂言	谰言
烂竽充数	滥竽充数
烂帐	烂账
滥等充数	滥竽充数
滥言	谰言
滥芋充数	滥竽充数
郎当	锒铛
狼{虎食	狼餐虎食
狼{虎咽	狼餐虎咽
狼x虎豹	狼虫虎豹
狼顾惊	狼顾麇惊
狼籍	狼藉
狼前虎後	狼前虎后
狼头	榔头
莨菪硷	莨菪碱
	琅
琅c入狱	锒铛入狱
稂秀	稂莠
头	榔头
朗朗上口	琅琅上口
浪废	浪费
浪废金钱	浪费金钱
浪花滚	浪花滚滚
浪酒f茶	浪酒闲茶
劳动锻练	劳动锻炼
劳P	劳动
劳帅动众	劳师动众
牢什子	劳什子
老成炼达	老成练达
老搭当	老搭档
老搭挡	老搭档
老而好学，如炳烛之明	老而好学，如秉烛之明
老虎的屁股摸不得	老虎屁股摸不得
老虎箝	老虎钳
老黄历	老皇历
老骥伏力	老骥伏枥
老奸巨滑	老奸巨猾
老奸具滑	老奸巨猾
老奸具猾	老奸巨猾
老奸俱滑	老奸巨猾
老奸俱猾	老奸巨猾
老趼	老茧
老老	姥姥
老俩口	老两口
老马识图	老马识途
老少爷	老少爷们
老生长谈	老生常谈
老声常谈	老生常谈
老实巴脚	老实巴交
老死不相来往	老死不相往来
老态龙锺	老态龙钟
老天拨地	老天拔地
老吾老以及人之老幼吾幼以及人之幼	老吾老以及人之老，幼吾幼以及人之幼
老鸭陈	老鸦陈
老约翰施特劳斯	老约翰・施特劳斯
老帐	老账
涝漕	醪糟
乐不可知	乐不可支
乐此不彼	乐此不疲
乐和和	乐呵呵
乐孜孜	乐滋滋
雷力风行	雷厉风行
雷历风行	雷厉风行
雷励风行	雷厉风行
雷射	镭射
雷庭万钧	雷霆万钧
雷呜	雷鸣
垒卵之危	累卵之危
磊落跌荡	磊落跌宕
	累累
泪眼蒙	泪眼朦胧
累K积苏	累块积苏
累坠	累赘
楞头楞脑	愣头愣脑
楞在那里	愣在那里
冷颤	冷战
冷茂	冷藏
冷寞	冷漠
冷偌冰霜	冷若冰霜
冷谈	冷淡
离和	离合
离奸	离间
离经畔道	离经叛道
离蔬释F	离蔬释
离乡背景	离乡背井
黎黑	黧黑
蠡酌管N	蠡酌管窥
礼上往来	礼尚往来
礼所当然	理所当然
礼贤下上	礼贤下士
李宝田	李保田
里勾外连	里勾外联
里姆斯基柯萨科夫	里姆斯基科萨科夫
哩哩罗罗	哩哩
理查得	理查德
理曲词穷	理屈词穷
醴泉	礼泉
力诫空谈	力戒空谈
历兵秣马	厉兵秣马
历兵粟马	厉兵粟马
历害	厉害
历精更始	励精更始
历精图治	励精图治
历精为治	励精为治
历马秣兵	厉马秣兵
历史纪录	历史记录
历行节约	厉行节约
厉兵株马	厉兵秣马
厉害得失	利害得失
厉害攸关	利害攸关
厉精图治	励精图治
立案侦察	立案侦查
立杆见影	立竿见影
立功援奖	立功授奖
立普斯	里普斯
立帐	立账
利果利民	利国利民
利害悠关	利害攸关
利令志	利令智昏
利玛窦	利马窦
利庭扫穴	犁庭扫穴
利雅得	利雅德
利欲薰心	利欲熏心
励粗图治	励精图治
励精图冶	励精图治
励精图志	励精图治
励行节约	厉行节约
沥沥拉拉	哩哩啦啦
俐亮	利亮
俐索	利索
砾金流石	铄金流石
詈夷为跖	詈夷为
连跨鲸	连鳌跨鲸
连邦	联邦
连二闳	连二并三
连二s三	连二赶三
连关性	连贯性
连合纤维	联合纤维
连结	联结
连结保险	联结保险
连结关系	联结关系
连结环	联结环
连结起来	联结起来
连结物	联结物
连结线	联结线
连结者	联结者
连络	联络
连络官	联络官
连络站	联络站
连袂	联袂
连绵词	联绵词
连绵字	联绵字
连篇t牍	连篇累牍
连篇t幅	连篇累幅
连翩	联翩
连系	联系
连想到	联想到
连枝共V	连枝共冢
连鬃胡子	连鬓胡子
怜	伶俐
怜牙齿	伶牙俐齿
涟猗	涟漪
枷	连枷
联成一片	连成一片
联贯	连贯
联贯性	连贯性
联接	连接
联接关系	连接关系
联接器	连接器
联结词	连接词
联结线	连接线
联绵	连绵
联绵不断	连绵不断
联篇累椟	连篇累牍
联篇累牍	连篇累牍
联锁店	连锁店
联属	连属
联缀	连缀
政	廉政
敛後疏前	敛后疏前
脸宠红润	脸庞红润
练习薄	练习簿
娈生儿	孪生儿
链钢	炼钢
链金术	炼金术
良晨美景	良辰美景
良唇吉日	良辰吉日
良霄	良宵
良心未抿	良心未泯
良秀不齐	良莠不齐
良药苦口利于病忠言逆耳利于行	良药苦口利于病，忠言逆耳利于行
良药苦门	良药苦口
凉并并	凉冰冰
凉台凉台	凉台
踉伧	踉跄
踉呛	踉跄
踉	踉跄
两败具伤	两败俱伤
两虎相斗必有一伤	两虎相斗，必有一伤
两极分	两极分化
两轻	两清
两情遣眷	两情缱绻
两相悄愿	两相情愿
两相情原	两相情愿
两相情愿	两厢情愿
两袖轻风	两袖清风
两着儿	两招儿
两鬃斑白	两鬓斑白
两鬃布满	两鬓布满
两鬃内陷	两鬓内陷
	两逼
量材录用	量才录用
量人为出	量入为出
量身度做	量身定做
聊胜於无	聊胜于无
寥廖无儿	寥寥无几
寥若辰星	寥若晨星
寥若星晨	寥若晨星
寥偌晨星	寥若晨星
廖廖	寥寥
廖廖无儿	寥寥无几
廖廖无几	寥寥无几
廖落	寥落
廖落晨星	寥落晨星
嘹	嘹亮
嘹望员	t望员
撩拔	撩拨
撩乱	缭乱
撩云拔雨	撩云拨雨
了草	潦草
了了草草	潦潦草草
了望	t望
了望塔	t望塔
了望台	t望台
了望远方	t望远方
了帐	了账
尥铞儿	钌铞儿
料简	料筒
列出题纲	列出提纲
列鼎重P	列鼎重茵
列好题纲	列好提纲
列甯格勒	列宁格勒
列女传	烈女传
列支敦斯登	列支敦士登
烈火乾柴	烈火干柴
烈士暮年壮心不已	烈士暮年，壮心不已
烈士徇名	烈士殉名
裂冠毁冕拔本塞源	裂冠毁冕，拔本塞源
邻里不合	邻里不和
林荫蔽天	林阴蔽天
林荫道	林阴道
林荫小路	林阴小路
临兵斗者皆阵列在前	临兵斗者，皆阵列在前
临床试验	临床实验
临摩	临摹
临颖县	临颍县
临阵磨枪不快也亮	临阵磨枪，不快也亮
淋漓尽至	淋漓尽致
琳满目	琳琅满目
r痹	麻痹
r风	麻风
r疹	麻疹
灰石	磷灰石
磷灰石糖	磷灰石
鳞次节比	鳞次栉比
鳞角	麟角
麟次栉比	鳞次栉比
麟角凤觜	麟角凤嘴
膦酸酯	磷酸酯
伶利	伶俐
伶牙利齿	伶牙俐齿
灵牙利齿	伶牙俐齿
囹圉	囹圄
陵轹	凌轹
陵弱暴寡	凌弱暴寡
陵夷	凌夷
零丁	伶仃
零丁孤苦	伶仃孤苦
领里乡党	邻里乡党
令嫒	令爱
令人恐布	令人恐怖
令人绚目	令人炫目
令人做呕	令人作呕
另类想象	另类想像
另作打算	另做打算
呤诗作赋	吟诗作赋
溜哒	溜达
溜Q	溜达
溜弹	榴弹
溜狗	遛狗
溜腿	遛腿
溜腿儿	遛腿儿
溜弯	遛弯
溜弯儿	遛弯儿
溜早	遛早
溜早儿	遛早儿
刘伯成	刘伯承
刘佩琪	刘佩琦
流宕忘反	流宕忘返
流芳後世	流芳后世
流风馀俗	流风余俗
流风馀韵	流风余韵
流光溢采	流光溢彩
流金砾石	流金铄石
流览	浏览
流览一遍	浏览一遍
流连忘反	流连忘返
流水不腐户枢不蠹	流水不腐，户枢不蠹
流水不腐卢枢不蠹	流水不腐，户枢不蠹
流水帐	流水账
流通两	流通量
流星s月	流星赶月
流言飞语	流言蜚语
流言非语	流言蜚语
留党查看	留党察看
留得青山在不愁没柴烧	留得青山在，不愁没柴烧
留得青山在不怕没柴烧	留得青山在，不怕没柴烧
留芳百世	流芳百世
留芳后世	流芳后世
留连	流连
留连不舍	流连不舍
留连忘返	流连忘返
留恋往返	流连忘返
留恋忘返	流连忘返
留尼旺岛	留尼汪岛
留校查看	留校察看
留言薄	留言簿
留有馀地	留有余地
遛达	溜达
榴散弹	榴霰弹
柳棉	柳绵
柳哨	柳梢
柳树上着刀桑树上出血	柳树上着刀，桑树上出血
六尺之	六尺之托
六根清静	六根清净
z碡	碌碡
Q	溜达
弯儿	遛弯儿
早儿	遛早儿
咯噔碑	格登碑
咯噔山	格登山
龙床快婿	东床快婿
龙飞凤午	龙飞凤舞
龙凤呈详	龙凤呈祥
龙虎攫	龙拿虎攫
龙虎跳	龙拿虎跳
龙虎掷	龙拿虎掷
龙盘虎据	龙盘虎踞
龙盘虎	龙盘虎拿
龙蟠虎踞	龙盘虎踞
龙腾虎越	龙腾虎跃
ザ	笼统
偻	喽
喽罗	喽
漏尽锺鸣	漏尽钟鸣
漏春光	漏泄春光
露头脚	露头角
芦沟桥	卢沟桥
泸沟桥	卢沟桥
炉火纯清	炉火纯青
V笋汁	芦笋汁
卤莽	鲁莽
卤莽地	鲁莽地
鲁滨逊	鲁宾逊
录录	碌碌
录相	录像
录相带	录像带
录相机	录像机
录相片	录像片
录象	录像
录象带	录像带
录象的	录像的
录象机	录像机
录象片	录像片
录象片儿	录像片儿
豆	绿豆
鹿葺	鹿茸
鹿死不择J	鹿死不择荫
碌卡	绿卡
路见不平拔刀相助	路见不平，拔刀相助
路遥知马力日久见人心	路遥知马力，日久见人心
路易士	路易斯
路迂不平	路遇不平
戮穿	戳穿
戮穿阴谋	戳穿阴谋
驴唇不对马咀	驴唇不对马嘴
驴唇马觜	驴唇马嘴
驴马觜	驴唇马嘴
缕拆	缕析
履获	屡获
绿鬓p颜	绿鬓朱颜
绿草如荫	绿草如茵
绿豆牙	绿豆芽
绿霉素	氯霉素
绿绒绒	绿茸茸
绿树成荫	绿树成阴
绿树荫浓	绿树浓荫
绿叶成荫	绿叶成阴
绿意蒙	绿意朦胧
绿荫	绿阴
绿荫葱葱	绿阴葱葱
乱烘烘	乱哄哄
乱马转换	乱码转换
乱七八遭	乱七八糟
略见一班	略见一斑
略窥一班	略窥一斑
仑次	伦次
伦墩大学	伦敦大学
伦巾	纶巾
沦肌夹髓	沦肌浃髓
轮陷	沦陷
论文儿	论文
论正	论证
罗伯特巴乔	罗伯特・巴乔
罗伯托巴乔	罗伯特・巴乔
罗得岛	罗德岛
罗德西亚	罗得西亚
罗孚宫	罗浮宫
罗里罗嗦	里嗦
罗哩罗嗦	里嗦
罗罗嗦嗦	嗦嗦
罗唆	嗦
罗嗦	嗦
罗纹	螺纹
罗皂	唣
罗唣	唣
哩唆	里嗦
唆唆	嗦嗦
萝I	罗勒
逻格斯	罗格斯
逻各斯	罗格斯
螺丝桨	螺旋桨
螺旋浆	螺旋桨
洛矶山	落矶山
洛克斐勒	洛克菲勒
洛山基	洛杉矶
洛杉机	洛杉矶
洛衫矶	洛杉矶
络泽不绝	络绎不绝
骆绎不绝	络绎不绝
落後地	落后地
落花有意流水无情	落花有意，流水无情
落阱下石	落井下石
落莫	落寞
落漠	落寞
落日的余辉	落日的余晖
落日余辉	落日余晖
落腮	络腮
落腮胡子	络腮胡子
落纱	络纱
落托	落拓
落叶归秋	落叶归根
落帐	落账
雒南	洛南
麻痹大义	麻痹大意
麻w不仁	麻痹不仁
麻疯病	麻风病
麻六甲	马六甲
麻六甲海	马六甲海
麻六甲海峡	马六甲海峡
麻麻呼呼	麻麻糊糊
麻雀虽小，五赃俱全	麻雀虽小，五脏俱全
麻雀虽小肝胆俱全	麻雀虽小，肝胆俱全
麻雀虽小五赃俱全	麻雀虽小，五脏俱全
麻雀虽小五脏俱全	麻雀虽小，五脏俱全
麻塞诸塞	麻萨诸塞
麻省理工	麻省理工学院
麻蹄声	马蹄声
q痹	麻痹
q风	麻风
q疯病	麻风病
q疹	麻疹
马兵俑	兵马俑
马不仃蹄	马不停蹄
马耳他	马尔他
马糊	马虎
马克斯主义	马克思主义
马拉威	马拉维
马来西大	马来西亚
马来西大学	马来西亚大学
马来稀亚	马来西亚
马利兰州	马里兰州
马玲薯	马铃薯
马毛o磔	马毛猬磔
马前率子	马前卒子
马塞诸塞	麻萨诸塞
马塞诸塞州	麻萨诸塞州
马	马扎
马札	马扎
马札儿人	马扎尔人
玛丽莲梦露	玛丽莲・梦露
玛丽雅	马利亚
玛丽娅	马利亚
蚂蜂	马蜂
埋茂	埋藏
埋头苦	埋头苦干
买帐	买账
麦杆	麦秆
麦杆吸管	麦秆吸管
麦穗两岐	麦穗两歧
麦秀两岐	麦秀两歧
卖禾妇	卖儿贴妇
卖哄髋	卖儿鬻女
卖国求容	卖国求荣
卖帐	卖账
脉博	脉搏
脉膊	脉搏
脉膊微弱	脉搏微弱
脉胳	脉络
脉胳分明	脉络分明
}}	脉脉
满不在	满不在乎
满腹经伦	满腹经纶
满腹经轮	满腹经纶
满怀期盼	满怀企盼
满脸绉纹	满脸皱纹
满目狼籍	满目狼藉
满漂亮的	蛮漂亮的
满腔热枕	满腔热忱
满台眩目	满台炫目
满园春色关不住一枝红杏出墙来	满园春色关不住，一枝红杏出墙来
满招损谦受益	满招损，谦受益
满州里	满洲里
满洲国	满州国
满坐风生	满座风生
曼陀林	曼德琳
曼陀琳	曼德琳
谩辞说	谩辞哗说
慢不经心	漫不经心
慢骂	谩骂
慢说	漫说
慢足要求	满足要求
漫不精心	漫不经心
漫藏诲盗	慢藏诲盗
漫天飞午	漫天飞舞
漫条斯理	慢条斯理
蔓陀罗	曼陀罗
忙里偷f	忙里偷闲
盲人摸像	盲人摸象
盲翁扪a	盲翁扪龠
毛发耸然	毛发悚然
毛骨惊然	毛骨悚然
毛骨森竦	毛骨森悚
毛骨耸然	毛骨悚然
毛骨竦然	毛骨悚然
毛难	毛南
毛难族	毛南族
毛绒绒的	毛茸茸的
毛邃自荐	毛遂自荐
毛燥	毛躁
茅塞顿河	茅塞顿开
卯足了劲	铆足了劲
茂宝图	藏宝图
茂传佛教	藏传佛教
茂经	藏经
茂历	藏历
茂羚羊	藏羚羊
茂龙卧虎	藏龙卧虎
茂匿	藏匿
茂品	藏品
茂起来	藏起来
茂身	藏身
茂身之处	藏身之处
茂书	藏书
茂污纳垢	藏污纳垢
茂语	藏语
茂着	藏着
茂族	藏族
冒然	贸然
冒然从事	贸然从事
冒天下之不讳	冒天下之大不讳
冒天下之不韪	冒天下之大不韪
冒天下之大不讳	冒天下之大不韪
貌和神离	貌合神离
么儿	幺儿
没精打彩	没精打采
没毛大x	没毛大虫
没没无闻	默默无闻
没命的干活	没命地干活
没甚么	没什么
没有规矩不成方圆	没有规矩，不成方圆
没有迹像显示	没有迹象显示
没有签定	没有签订
眉飞色午	眉飞色舞
眉齿鲵	眉庞齿鲵
眉如臣蚕	眉如卧蚕
眉捎	眉梢
眉头眼後	眉头眼后
眉头一皱计上心来	眉头一皱，计上心来
梅乾菜	霉干菜
梅竹马	青梅竹马
媒体暴光	媒体曝光
楣运当头	霉运当头
煤碳	煤炭
煤碳工业	煤炭工业
霉乾菜	霉干菜
每况欲下	每况愈下
美利坚共和国	美利坚合众国
美仑美奂	美轮美奂
美伦美奂	美轮美奂
美伦美唤	美轮美奂
门道若市	门庭若市
门坎	门槛
门庭偌市	门庭若市
门心无愧	扪心无愧
扪a扣盘	扪龠扣盘
	蒙蒙
飨赣	蒙蒙细雨
	蒙蒙
朦朦	蒙蒙
	蒙
猛烈评击	猛烈抨击
猛省	猛醒
蒙胧	蒙
蒙不清	朦胧不清
蒙地出现	朦胧地出现
蒙感觉	朦胧感觉
蒙情感	朦胧情感
蒙情缘	朦胧情缘
蒙夜色	朦胧夜色
蒙隐约	朦胧隐约
蒙月色	朦胧月色
蒙蒙	朦朦胧胧
孟斐斯	孟菲斯
孟庭伟	孟庭苇
迷离惝恍	迷离惝U
迷漫	弥漫
迷	迷蒙
迷朦	迷蒙
迷朦细雨	迷飨赣
迷蒙恍惚	迷骰秀
迷蒙蒙的	迷鞯
迷蒙飘逸	迷髌逸
迷蒙一片	迷饕黄
迷蒙之中	迷髦中
迷迷胡胡	迷迷糊糊
迷天大谎	弥天大谎
迷语	谜语
谜案	迷案
谜天	弥天
谜天大谎	弥天大谎
糜费	靡费
糜糜之音	靡靡之音
靡不有初鲜克有终	靡不有初，鲜克有终
靡烂不堪	糜烂不堪
靡烂性	糜烂性
靡所m从	靡所适从
靡衣食	靡衣偷食
米盖朗基罗	米开朗基罗
米开兰基罗	米开朗基罗
米苏里	密苏里
米苏里州	密苏里州
漫	弥漫
	弥蒙
密而不宣	秘而不宣
密法	秘法
密籍	秘籍
密切党群	密切党群关系
密枣	蜜枣
绵联	绵连
棉薄之力	绵薄之力
棉里藏针	绵里藏针
棉子	棉籽
免强	勉强
免强答应	勉强答应
免为其难	勉为其难
免予处分	免于处分
沔县	勉县
a拾地芥	俯拾地芥
a拾仰取	俯拾仰取
a首帖耳	俯首帖耳
腼颜人世	腆颜人世
腼颜事敌	腆颜事敌
腼颜天壤	腆颜天壤
面宠福相	面庞福相
面宠红润	面庞红润
面黄饥瘦	面黄肌瘦
面面具到	面面俱到
面声闻暇迩	面声闻遐迩
面授面宜	面授机宜
苗侨伟	苗乔伟
描淡写	轻描淡写
描红薄	描红簿
淼茫	渺茫
渺如黄鹤	杳如黄鹤
渺视	藐视
渺无音信	杳无音信
渺远	邈远
缈茫	渺茫
藐小	渺小
邈以山河	邈似山河
妙着	妙招
庙里街	庙李街
乜斜缠帐	乜斜缠账
民不潦生	民不聊生
民风纯朴	民风淳朴
民富国	民富国强
民生凋蔽	民生凋敝
民为贵君为轻	民为贵，君为轻
民惟邦本	民为邦本
子	抿子
名不符实	名不副实
名不付实	名不副实
名地	各地
名份	名分
名符其实	名副其实
名付其实	名副其实
名公钜卿	名公巨卿
名公钜人	名公巨人
名\利锁	名缰利锁
名列前矛	名列前茅
名卿钜公	名卿巨公
名实不付	名实不符
名实难付	名实难副
名实相符	名实相副
名闻暇迩	名闻遐迩
名信片	明信片
名行其是	各行其是
名义帐户	名义账户
名有	各有
名躁一时	名噪一时
名知	明知
明比为奸	朋比为奸
明辩是非	明辨是非
明查暗访	明察暗访
明察秋毫之末而不见舆薪	明察秋毫之末，而不见舆薪
明存实亡	名存实亡
明鼓而攻之	鸣鼓而攻之
明黄花	明日黄花
明火执杖	明火执仗
明旌	铭旌
明尼苏大	明尼苏达
明尼苏大学	明尼苏达大学
明牌	名牌
明枪易躲暗箭难防	明枪易躲，暗箭难防
明j容易躲，暗剑最难防	明枪容易躲，暗剑最难防
明j容易躲，暗箭最难防	明枪容易躲，暗箭最难防
明人不作暗事	明人不做暗事
明唐	明堂
明天起程	明天启程
明细帐	明细账
明星丰采	明星风采
明行山有虎	明知山有虎
明修栈道，暗度陈仓	明修栈道，暗渡陈仓
明修栈道暗渡陈仓	明修栈道，暗渡陈仓
冥蒙	溟
冥昭瞢	冥昭瞢暗
溟茫	冥茫
溟溟	冥冥
瞑思苦想	冥思苦想
瞑顽不灵	冥顽不灵
命薄缘a	命薄缘悭
命运悠关	命运攸关
缪力同心	戮力同心
摸棱两可	模棱两可
摸梭两可	模棱两可
摹仿	模仿
摹拟	模拟
模范事绩	模范事迹
模胡	模糊
模似	模拟
模似试题	模拟试题
模似题	模拟题
模写	摹写
摩拜	膜拜
摩仿	模仿
摩厉以须	磨砺以须
摩拖车	摩托车
磨不开	抹不开
磨擦力	摩擦力
磨擦声	摩擦声
磨得开	抹得开
磨电灯	摩电灯
磨而不磷涅而不缁	磨而不磷，涅而不缁
磨肩擦踵	摩肩擦踵
磨肩接踵	摩肩接踵
磨练	磨炼
磨练出来	磨炼出来
磨练得	磨炼得
磨练技术	磨炼技术
磨练意志	磨炼意志
磨练自己	磨炼自己
磨拳擦掌	摩拳擦掌
魔难	磨难
抹马历兵	秣马厉兵
抹煞	抹杀
抹煞成绩	抹杀成绩
抹月秕风	抹月披风
末可全抛一片心	未可全抛一片心
末稍	末梢
末雨绸谬	未雨绸缪
末雨绸缪	未雨绸缪
殁世不忘	没世不忘
陌上陇间	陌上垄间
秣兵历马	秣马厉兵
秣马利兵	秣马厉兵
秣马砺兵	秣马厉兵
莫不关心	漠不关心
莫明	莫名
莫明惊诧	莫名惊诧
莫明其妙	莫名其妙
莫索里尼	墨索里尼
莫文尉	莫文蔚
莫札特	莫扎特
莫中一是	莫衷一是
莫衷一事	莫衷一是
	脉脉
寞寞无声	默默无声
寞然	漠然
墨尔钵	墨尔本
墨迹未十	墨迹未干
墨守陈规	墨守成规
默不做声	默不作声
默	默念
默默含情	脉脉含情
默守	墨守
默守成规	墨守成规
谋画	谋划
谋取暴利	牟取暴利
谋事在人成事在天	谋事在人，成事在天
牡丹虽好全仗绿叶扶持	牡丹虽好，全仗绿叶扶持
姆指	拇指
木猴而冠	沐猴而冠
木乾鸟栖	木干鸟栖
木巳成舟	木已成舟
木犀	木樨
目不瑕给	目不L给
目不转晴	目不转睛
目步转睛	目不转睛
目瞪舌	目瞪舌强
目空馀子	目空余子
目乱精迷	目乱情迷
目无馀子	目无余子
目指气使	颐指气使
暮色蒙	暮色朦胧
暮氧沉沉	暮气沉沉
穆索尔期基	穆索尔斯基
风跃云	拿风跃云
云攫石	拿云攫石
云握雾	拿云握雾
拿班作势	拿班做势
拿斑作势	拿班做势
拿粗夹细	拿粗挟细
拿的出手	拿得出手
拿腔做势	拿腔作势
内查处调	内查外调
内U	内禅
内处夹击	内外夹击
内哄	内讧
内茂	内藏
内容浮浅	内容肤浅
内容详实	内容翔实
内外夹功	内外夹攻
内外跤困	内外交困
那到没关系	那倒没关系
那个背后不说人	哪个背后不说人
那个时侯	那个时候
那管	哪管
那管它	哪管它
那来的	哪来的
那里的	哪里的
那里知道	哪里知道
那么姣媚	那么娇媚
那麽	那么
那末	那么
那时侯	那时候
好吗	你好吗
们的	你们的
自己	你自己
耐烦极了	不耐烦极了
耐硷性	耐碱性
男女搭配干活不累	男女搭配，干活不累
男子蓝球	男子篮球
南加罗林纳洲	南卡罗来纳州
南卡罗来州	南卡罗来纳州
南落县	南乐县
南猿北辙	南辕北辙
难物论	唯物论
难以其才	难尽其才
难以想象	难以想像
难于呼吸	难以呼吸
难于判断	难以判断
难于启齿	难以启齿
难于忘怀	难以忘怀
难于维系	难以维系
难于掌握	难以掌握
难于招架	难以招架
囊萤照光	囊萤照读
囊膪	囊揣
挠腮薅	挠腮撅耳
闹轰轰	闹哄哄
闹烘烘	闹哄哄
C约	绰约
能歌善午	能歌善舞
能磨练人	能磨炼人
能曲能伸	能屈能伸
尼格罗澳大利亚人种	尼格罗－澳大利亚人种
尼加拉瀑布	尼亚加拉瀑布
泥泞难长	泥泞难走
泥瓦浆	泥瓦匠
泥子	腻子
霓红	霓虹
霓红灯	霓虹灯
你打算怎办	你打算怎么办
你是哪你人	你是哪里人
你追我s	你追我赶
拟不于伦	拟于不伦
拟于不论	拟于不伦
不於伦	拟不于伦
逆情背理	逆情悖理
逆天背理	逆天悖理
年渡	年度
年分	年份
年高德邵	年高德劭
年高德勋	年高德p
年过古希	年过古稀
年迁古希	年近古稀
年溲马勃	牛溲马勃
R鱼上竿	鲇鱼上竿
R鱼上竹	鲇鱼上竹
捻花微笑	拈花微笑
念念有辞	念念有词
鸟迹x丝	鸟迹虫丝
鸟枪换h	鸟枪换炮
亭亭	袅袅婷婷
婷婷	袅袅婷婷
尿泡	尿脬
啮雪吞	啮雪吞毡
嗫诺	嗫嚅
嗫嚅小	嗫嚅小儿
Y兀危	臬兀
蹑F担簦	蹑值ｔ
蹑F檐簦	蹑珠荇
蘖根祸种	孽根祸种
m臂之好	啮臂之好
m齿类	啮齿类
m血沁骨	啮血沁骨
艹堇	啮齿类
宁缺毋烂	宁缺毋滥
宁缺勿滥	宁缺毋滥
宁为工碎，不为瓦全	宁为玉碎，不为瓦全
宁为鸡口不为牛后	宁为鸡口，不为牛后
宁为玉碎不为瓦全	宁为玉碎，不为瓦全
宁遗勿滥	宁遗毋滥
凝炼	凝练
牛骥同o	牛骥同皂
牛头不对马咀	牛头不对马嘴
忸忸捏捏	扭扭捏捏
扭带	纽带
扭动腰枝	扭动腰肢
扭扣	纽扣
扭扭怩怩	忸忸怩怩
纽西兰人	新西兰人
纽泽西	新泽西
钮扣	纽扣
钮扣孔	纽扣孔
农付产品	农副产品
农林牧付渔	农林牧副渔
浓墨重采	浓墨重彩
浓情密意	浓情蜜意
浓荫	浓阴
浓荫庇覆	浓阴庇覆
浓荫铺地	浓阴铺地
浓装艳抹	浓妆艳抹
弄粉调p	弄粉调朱
弄虚做假	弄虚作假
弄绉	弄皱
奴颜卑膝	奴颜婢膝
驽箭离弦	弩箭离弦
怒不可揭	怒不可遏
怒不可竭	怒不可遏
怒从心头起恶向胆边生	怒从心头起，恶向胆边生
怒涛凶涌	怒涛汹涌
怒形於色	怒形于色
女姓	女性
女子蓝球	女子篮球
虐疾	疟疾
暖呼呼	暖乎乎
暖昧	暧昧
暖溶溶	暖融融
挪作它用	挪作他用
诺曼地	诺曼底
诺曼地登陆	诺曼第登陆
诺曼第	诺曼底
喏喏连声	诺诺连声
欧打	殴打
欧几里得	欧几里德
呕气	怄气
呕心呖心	呕心沥血
偶而	偶尔
偶象	偶像
沤心	呕心
沤心沥血	呕心沥血
鍪	扒手
拍手喝采	拍手喝彩
拍手喝采声	拍手喝彩声
排除干挠	排除干扰
排它性	排他性
排脱	摆脱
潘朵拉	潘多拉
攀高接贵	攀高结贵
攀龙附风	攀龙附凤
攀龙凤	攀龙托凤
攀援	攀缘
盘根措节	盘根错节
盘根错结	盘根错节
盘据	盘踞
盘跚	蹒跚
盘石	磐石
盘石犬牙	磐石犬牙
盘石桑苞	磐石桑苞
盘石之安	磐石之安
盘石之固	磐石之固
盘u	盘陀
盘帐	盘账
根错节	盘根错节
木朽株	盘木朽株
磐竹难书	罄竹难书
蟠错	盘错
蟠根错节	盘根错节
蟠据	盘踞
蟠据固结	盘踞固结
蟠踞	盘踞
蟠曲	盘曲
蟠曲而上	盘曲而上
蟠石	磐石
判辞	判词
叛乱份子	叛乱分子
畔道离经	叛道离经
滂胱	膀胱
旁皇	彷徨
旁偌无人	旁若无人
旁L远绍	旁搜远绍
旁通曲	旁通曲畅
旁文义	旁文剩义
旁徵博引	旁征博引
旁证博引	旁征博引
抛地有声	掷地有声
浔铍诶	炮鳖脍鲤
浞锱肓	炮凤烹龙
跑哮	咆哮
跑帐	跑账
泡制	炮制
h凤烹龙	炮凤烹龙
h龙烹凤	炮龙烹凤
陪不是	赔不是
陪小心	赔小心
陪笑脸	赔笑脸
培养人材	培养人才
赔帐	赔账
佩服之致	佩服之至
配衬	陪衬
喷腾	奔腾
抨然心动	怦然心动
烹龙浞	烹龙炮凤
烹龙h凤	烹龙炮凤
彭湖县	澎湖县
蓬荜生辉	蓬筚生辉
蓬壁生辉	蓬筚生辉
蓬壁增辉	蓬筚生辉
蓬户Y牖	蓬户瓮牖
蓬涞	蓬莱
蓬门荜户	蓬门筚户
蓬生麻中不扶自直	蓬生麻中，不扶自直
篷荜	蓬荜
篷荜生辉	蓬荜生辉
篷荜增辉	蓬筚生辉
篷门荜户	蓬门荜户
篷门弊户	蓬门荜户
篷篷勃勃	蓬蓬勃勃
篷头垢面	蓬头垢面
膨涨	膨胀
批漏	纰漏
批漏百出	纰漏百出
批沙拣金	披沙拣金
批郄导U	批隙导U
批S导U	批隙导U
批隙导[	批隙导窍
披肝历胆	披肝沥胆
披肝呖胆	披肝沥胆
披麻带孝	披麻戴孝
披糜	披靡
披洒	泼洒
披星带月	披星戴月
披庥带孝	披麻戴孝
劈里啪啦	噼里啪啦
劈哩啪啦	噼里啪啦
劈啪	噼啪
劈拍声	劈啪声
劈劈叭叭	劈劈啪啪
劈帐	劈账
劈帐分红	劈账分红
皮簧	皮黄
皮开肉锭	皮开肉绽
皮茄克	皮夹克
皮之不存毛将焉附	皮之不存，毛将焉附
芘苤	芘]
疲塌	疲沓
疲於奔命	疲于奔命
疲於供命	疲于供命
蚍蜉憾树	蚍蜉撼树
匹马单j	匹马单枪
偏辟	偏僻
偏宜	偏移
翩翩起午	翩翩起舞
骈四骊六	骈四俪六
漂零	飘零
漂零蓬断	飘零蓬断
漂渺	缥缈
漂蓬断梗	飘蓬断梗
漂帐	漂账
缥渺	缥缈
飘泊	漂泊
飘泊不定	漂泊不定
飘泊生活	漂泊生活
飘泊他乡	漂泊他乡
飘泊无定	漂泊无定
飘泊异乡	漂泊异乡
飘流	漂流
飘眇	缥缈
飘渺	缥缈
飘邈	缥缈
飘r	飘扬
飘洋过海	漂洋过海
飘^	飘扬
飘u	飘摇
飘_	飘摇
G悍	剽悍
拼拼凑揍	拼拼凑凑
拼拼揍揍	拼拼凑凑
拼揍	拼凑
贫脊	贫瘠
频临	濒临
频临绝迹	濒临绝迹
频临破灭	濒临破灭
品不高	品格不高
品苟	品茗
品学兼忧	品学兼优
平白无辜	平白无故
平臣	平卧
平话	评话
平剧	评剧
平空	凭空
平铺直序	平铺直叙
平时不烧	平时不烧香
平时不烧香急来抱佛脚	平时不烧香，急来抱佛脚
平形四边	平行四边
评击	抨击
凭白无故	平白无故
凭单日记帐	凭单日记账
凭藉	凭借
凭空想象	凭空想像
凭甚么	凭什么
凭什麽	凭什么
凭添	平添
苹水相逢	萍水相逢
屏除	摒除
屏弃	摒弃
瓶沈簪折	瓶沉簪折
萍踪狭影	萍踪侠影
泼刺刺	泼剌剌
泼浪鼓	拨浪鼓
N酵	发酵
w酵	发酵
迫不急待	迫不及待
迫於眉睫	迫于眉睫
破巢馀卵	破巢余卵
破斧沉舟	破釜沉舟
破釜沈舟	破釜沉舟
破觚为圜	破觚为圆
破镜重园	破镜重圆
破旧家俱	破旧家具
破矩为圜	破矩为圆
破玩意	破玩意儿
剖示图	剖视图
扑风捉影	捕风捉影
扑朔谜离	扑朔迷离
扑素	朴素
扑塑	扑朔
扑塑迷离	扑朔迷离
扑溯迷离	扑朔迷离
扑天盖地	铺天盖地
扑嗵一声	扑通一声
铺青迭翠	铺青叠翠
噗通一声	扑通一声
匍伏	匍匐
璞玉诨金	璞玉浑金
朴素而雅	朴素典雅
普洱哈呢族彝族自治县	普洱哈尼族彝族自治县
普林斯敦大学	普林斯顿大学
曝露出	暴露出
七尺之驱	七尺之躯
七咀八舌	七嘴八舌
七年之病求三年之艾	七年之病，求三年之艾
七纵七禽	七纵七擒
妻豪仙	妻儿老少
妻豪闲	妻儿老小
妻离于散	妻离子散
jj遑遑	jj惶惶
栖栖遑遑	栖栖惶惶
期未余额	期末余额
欺悔羞辱	欺侮羞辱
欺瞒夹帐	欺瞒夹账
嘁哩喀嚓	嘁哩喀喳
嘁嘁嚓嚓	嘁嘁喳喳
齐心懔	齐心并力
齐帐	齐账
岐出岐入	歧出歧入
岐路	歧路
岐路亡羊	歧路亡羊
岐山县	歧山县
岐视	歧视
其实难付	其实难副
其势凶凶	其势汹汹
其它窗口	其他窗口
奇耻大库	奇耻大辱
奇情异采	奇情异彩
歧岖	崎岖
祈连山	祁连山
骑墙份子	骑墙分子
棋高一着缚手缚脚	棋高一着，缚手缚脚
棋输先著	棋输先着
企待	期待
启z振聋	启聩振聋
启锚	起锚
启盟教育	启蒙教育
杞宋无徵	杞宋无征
起博器	起搏器
起程	启程
起迄	起讫
起讼	起诉
起造摸黑	起早摸黑
起绉	起皱
绮襦纨F	绮襦纨绔
气冲宵汉	气冲霄汉
气喘嘘嘘	气喘吁吁
气喘吁嘘	气喘吁吁
气侯	气候
气侯变化	气候变化
气侯宜人	气候宜人
气侯异常	气候异常
气乎乎	气呼呼
气乎乎的	气呼呼的
气极败坏	气急败坏
气慨	气概
气门心	气门芯
气势气磅礴	气势磅礴
气势凶凶	气势汹汹
气吞虹U	气吞虹霓
气像万千	气象万千
气像卫星	气象卫星
气像学家	气象学家
弃其馀鱼	弃其余鱼
汽轮机	气轮机
恰如其份	恰如其分
恰谈	洽谈
洽如	恰如
洽如其分	恰如其分
千部一腔千人一面	千部一腔，千人一面
千锤百链	千锤百炼
千钓一发	千钧一发
千骄百媚	千娇百媚
千金一	千金一壶
千里不同风百里不同俗	千里不同风，百里不同俗
千里r粮，士有饥色	千里馈粮，士有饥色
千里莺啼绿映红水村山郭酒旗风	千里莺啼绿映红，水村山郭酒旗风
千里之，溃于蚁穴	千里之堤，溃于蚁穴
千里之堤毁于一旦	千里之堤，毁于一旦
千里之堤毁于蚁穴	千里之堤，毁于蚁穴
千里之堤溃于蚁穴	千里之堤，溃于蚁穴
千里之行，始於足下	千里之行，始于足下
千里之行始于脚下	千里之行，始于脚下
千里之行始于足下	千里之行，始于足下
千秋万事	千秋万世
千丝万褛	千丝万缕
千头万序	千头万绪
迁回曲折	迂回曲折
迁徒	迁徙
F阳	千阳
牵合傅会	牵合附会
牵就	迁就
牵联	牵连
牵强符会	牵强附会
签定	签订
签字盖戮	签字盖戳
前跋後F	前跋后F
前不巴村后不巴店	前不巴村，后不巴店
前不见古人后不见来者	前不见古人，后不见来者
前赴後继	前赴后继
前歌後舞	前歌后舞
前呼後拥	前呼后拥
前街後巷	前街后巷
前襟後裾	前襟后裾
前鞠后恭	前倨后恭
前鞠后躬	前倨后恭
前倨後恭	前倨后恭
前踞后恭	前倨后恭
前门拒虎后门进狼	前门拒虎，后门进狼
前仆後踣	前仆后踣
前仆後继	前仆后继
前扑后继	前仆后继
前扑后起	前仆后起
前人失脚后人把滑	前人失脚，后人把滑
前人栽树后人乘凉	前人栽树，后人乘凉
前世不忘，后世之师	前事不忘，后事之师
前世不忘后世之师	前世不忘，后世之师
前事不忘后事之师	前事不忘，后事之师
前思後想	前思后想
前途无亮	前途无量
前危後则	前危后则
前些时侯	前些时候
前仰後合	前仰后合
前意识	潜意识
前因後果	前因后果
前於	前于
前瞻後顾	前瞻后顾
虔南	全南
钱而不舍	锲而不舍
乾巴巴	干巴巴
乾巴巴的	干巴巴的
乾巴利脆	干巴利脆
乾巴利落	干巴利落
乾爸爸	干爸爸
乾杯祝福	干杯祝福
乾草市场	干草市场
乾草种子	干草种子
乾柴烈火	干柴烈火
乾脆	干脆
乾脆地	干脆地
乾脆利落	干脆利落
乾脆利索	干脆利索
乾旱	干旱
乾旱地区	干旱地区
乾净	干净
乾净利落	干净利落
乾净利索	干净利索
乾净俐落	干净利落
乾酪样变	干酪样变
乾毛巾布	干毛巾布
乾抹布	干抹布
乾啼湿哭	干啼湿哭
乾性眼炎	干性眼炎
乾椰子肉	干椰子肉
乾燥	干燥
乾燥病的	干燥病的
乾燥机	干燥机
乾燥剂	干燥剂
乾燥状态	干燥状态
箝口侧目	钳口侧目
箝口结舌	钳口结舌
箝形攻势	钳形攻势
箝制	钳制
潜茂	潜藏
潜然	潸然
潜然泪下	潸然泪下
潜在地	潜在的
n麻疹	荨麻疹
浅辄止	浅尝辄止
遣辞	遣词
遣辞措意	遣词措意
遣将徵兵	遣将征兵
遣责	谴责
欠收	歉收
欠收自补	歉收自补
欠帐	欠账
歉虚	谦虚
枪烟h雨	枪烟炮雨
枪枝	枪支
枪枝弹药	枪支弹药
踉	跄踉
	跄跄
强差人意	差强人意
强劣嘴	强唇劣嘴
强秩踔	强干弱枝
强硷	强碱
强驽之末	强弩之末
强努之末	强弩之末
强忍更咽	强忍哽咽
强徵队员	强征队员
强嘴拗舌	犟嘴拗舌
强嘴硬牙	犟嘴硬牙
强做欢颜	强作欢颜
强做解人	强作解人
跷足而待	翘足而待
敲锣放h	敲锣放炮
敲山振虎	敲山震虎
敲榨	敲诈
敲榨勒索	敲诈勒索
敲竹	敲竹杠
乔治华盛顿	乔治・华盛顿
乔治史考特	乔治・史考特
乔妆打扮	乔装打扮
侨装	乔装
侨装打扮	乔装打扮
桥归桥路归路	桥归桥，路归路
桥粱	桥梁
憔灼	焦灼
x	憔悴
巧夺天公	巧夺天工
巧言另色	巧言令色
巧装	乔装
巧装打扮	乔装打扮
翘趣	翘楚
切成两分	切成两份
切切私语	窃窃私语
切中恳綮	切中肯綮
切中世弊	切中时弊
茄克	夹克
怯生怯气	怯声怯气
窃钩者诛窃国者侯	窃钩者诛，窃国者侯
窃窃偶语	窃窃私语
窃锺掩耳	窃钟掩耳
亲睐	青睐
亲威	亲戚
亲兄弟明算帐	亲兄弟明算账
琴断p弦	琴断朱弦
勤有功嬉无益	勤有功，嬉无益
螓首蛾眉	螓首娥眉
寝关曝k	寝关曝纩
寝苫枕K	寝苫枕块
寝苫枕	寝苫枕块
青出于兰而胜于蓝	青出于蓝而胜于蓝
青出于蓝，而胜于蓝	青出于蓝而胜于蓝
青出于蓝而胜于兰	青出于蓝而胜于蓝
青出於蓝	青出于蓝
青丰县	清丰县
青红o白	青红皂白
青康藏高	青康藏高原
青茂	青藏
青茂高原	青藏高原
青山遮不住毕竟东流去	青山遮不住，毕竟东流去
青天霹雳	晴天霹雳
青烟燎绕	青烟缭绕
青h	青冈
氢原素	氢元素
轻脆悦耳	清脆悦耳
轻而一举	轻而易举
轻风徐来	清风徐来
轻歌曼午	轻歌曼舞
轻歌慢舞	轻歌曼舞
轻歌漫舞	轻歌曼舞
轻描谈写	轻描淡写
轻气球	氢气球
轻身徇义	轻身殉义
轻r	轻扬
轻^	轻扬
轻绫「	轻徭薄赋
轻一	轻易
轻於鸿毛	轻于鸿毛
倾城顷国	倾城倾国
倾复	倾覆
倾刻	顷刻
倾刻间	顷刻间
倾刻之间	顷刻之间
倾盆人雨	倾盆大雨
清查帐目	清查账目
清彻	清澈
清彻见底	清澈见底
清歌妙舞	轻歌妙舞
清过来	请过来
清过去	请过去
清浑o白	清浑皂白
清净无为	清静无为
清亮透彻	清亮透澈
清算帐目	清算账目
清香肆溢	清香四溢
清议不容	清仪不容
清帐	清账
情不自己	情不自已
情不自尽	情不自禁
情非得以	情非得已
情份	情分
情见於色	情见于色
情素	情愫
情无旁鹜	情无旁骛
情绪松驰	情绪松弛
情义深重	情意深重
情有可愿	情有可原
顷城顷国	倾城倾国
顷国顷城	倾国倾城
顷家荡产	倾家荡产
顷盆大雨	倾盆大雨
请君人瓮	请君入瓮
请君入Y	请君入瓮
请稍侯	请稍候
请先入Y	请先入瓮
庆父不死鲁难未已	庆父不死，鲁难未已
磬笔难书	罄笔难书
磬竹难书	罄竹难书
穷而後工	穷而后工
穷罕└	穷儿暴富
穷鼠m	穷鼠啮狸
穷形尽像	穷形尽相
穷源竟委	穷原竟委
穷源意委	穷源竟委
穹窿	穹隆
茕茕孑立形影相吊	茕茕孑立，形影相吊
孑立，形影相吊	茕茕孑立，形影相吊
孑立形影相吊	茕茕孑立，形影相吊
邱吉尔	丘吉尔
秋虫瞅鸣	秋虫啾鸣
秋后算帐	秋后算账
秋後算账	秋后算账
秋收万颗子	秋收万颗籽
Fa	秋千
求生不得求死不能	求生不得，求死不能
球蘑机	球磨机
曲高合寡	曲高和寡
曲意承奉	曲意奉承
曲指可数	屈指可数
屈伏	屈服
屈Y巨瓠	屈谷巨瓠
屈意逢迎	曲意逢迎
除	祛除
蛐蟮	曲蟮
趋炎s热	趋炎赶热
趋之若骛	趋之若鹜
趋之偌鹜	趋之若鹜
蠼螋	R螋
Y鹆	鸲鹆
取保侯审	取保候审
取精用宏	取精用弘
取销	取消
取之不尽用之不竭	取之不尽，用之不竭
全幅武装	全副武装
全国纪录	全国记录
全家迁徒	全家迁徙
全日震幅	全日振幅
全神关注	全神贯注
全神惯注	全神贯注
全天侯	全天候
权横轻重	权衡轻重
权势叶位	权势易位
泉石膏盲	泉石膏肓
泉水丁冬	泉水丁东
泉水叮咚	泉水丁东
拳不离手曲不离口	拳不离手，曲不离口
拳头上立得人胳膊上走得马	拳头上立得人，胳膊上走得马
	拳拳
持意	拳拳之意
鬈曲	卷曲
犭忽犭聿	忽律
犬牙盘石	犬牙磐石
劝戒	劝诫
缺之不恭	却之不恭
s病延年	却病延年
s金暮夜	却金暮夜
s老还童	却老还童
s行求前	却行求前
s之不恭	却之不恭
雀瘢	雀斑
雀然无声	悄然无声
鹊巢鸠	鹊巢鸠占
群芳争妍	群芳争艳
群魔乱午	群魔乱舞
群轻折抽	群轻折轴
群情欢洽谈	群情欢洽
群情激愤	群情激奋
群山迭翠	群山叠翠
群星璀灿	群星璀璨
群蚁附	群蚁附膻
染风俗	染风习俗
染蓝涅o	染蓝涅皂
饶勇	骁勇
饶勇善战	骁勇善战
惹事生非	惹是生非
热呼	热乎
热呼呼	热乎乎
热火潮天	热火朝天
热坑	热炕
热坑凉床	热炕凉床
热坑头	热炕头
热坑头　	热炕头
热剌剌	热辣辣
热涨冷缩	热胀冷缩
热中	热衷
热中者	热衷者
热衷子	热中子
人比人气死人	人比人，气死人
人不犯我我不犯人	人不犯我，我不犯人
人不敷出	入不敷出
人才倍出	人才辈出
人才汇萃	人才荟萃
人材	人才
人材出众	人才出众
人材济济	人才济济
人材外流	人才外流
人参鹿葺	人参鹿茸
人刀阔斧	大刀阔斧
人而无信	言而无信
人而无信不知其可	人而无信，不知其可
人非圣贤孰能无过	人非圣贤，孰能无过
人风人浪	大风大浪
人浮于食	人浮于事
人浮于世	人浮于事
人浮於事	人浮于事
人面挑花	人面桃花
人民当家作主	人民当家做主
人千世界	大千世界
人情事故	人情世故
人穷智短	人穷志短
人人有则	人人有责
人仁人义	大仁大义
人生自古谁无死留取丹心照汗青	人生自古谁无死，留取丹心照汗青
人手人脚	大手大脚
人同此心心同此理	人同此心，心同此理
人头帐	人头账
人为财死鸟为食亡	人为财死，鸟为食亡
人为刀俎我为鱼肉	人为刀俎，我为鱼肉
人无远虑必有近忧	人无远虑，必有近忧
人象	人像
人心皇皇	人心惶惶
人心遑遑	人心惶惶
人心齐泰山移	人心齐，泰山移
人言利博	仁言利博
人言责责	人言啧啧
人义火亲	大义灭亲
人有敷出	入有敷出
人在屋檐下不得不低头	在人屋檐下，不得不低头
人之长情	人之常情
人之将死其言也善	人之将死，其言也善
亻匡	
仁义礼智信	仁义礼知信
仁者见仁智者见智	仁者见仁，智者见智
忍劳忍怨	任劳任怨
忍气吞卢	忍气吞声
忍贼作父	认贼作父
认贼做父	认贼作父
认帐	认账
任何时侯	任何时候
任人为贤	任人唯贤
任消遥	任逍遥
任意飘泊	任意漂泊
日成	日程
日尔曼	日耳曼
日光朦胧	日光o
日规	日晷
日规仪	日晷仪
日环蚀	日环食
日计不足岁计有余	日计不足，岁计有余
日记薄	日记簿
日记帐	日记账
日偏蚀	日偏食
日全蚀	日全食
日儒月染	日濡月染
日色朦胧	日色o
日升月a	日升月恒
日蚀	日食
日月合壁	日月合璧
日月经天江河行地	日月经天，江河行地
戎骄戎躁	戒骄戒躁
戎马倥	戎马倥偬
容光涣发	容光焕发
容膝之安一肉之味	容膝之安，一肉之味
溶贯	融贯
溶会	融会
溶会贯通	融会贯通
溶通	融通
融汇贯通	融会贯通
融汇惯通	融会贯通
融解度	溶解度
融解度低	溶解度低
融恰	融洽
融岩	熔岩
g解热	熔解热
柔肠才断	柔肠寸断
柔以制钢	柔以制刚
柔中带钢	柔中带刚
揉杂	糅杂
糅和	柔和
如此以致于	如此以至于
如法泡制	如法炮制
如法h制	如法炮制
如梗在喉	如鲠在喉
如虎添冀	如虎添翼
如火如茶	如火如荼
如雷灌耳	如雷贯耳
如临人敌	如临大敌
如毛饮血	茹毛饮血
如人饮水冷暖自知	如人饮水，冷暖自知
如日中大	如日中天
如实交待	如实交代
如闻其声如见其人	如闻其声，如见其人
如原以偿	如愿以偿
如缘大笔	如椽大笔
如愿以尝	如愿以偿
如坠五里	如坠雾里
儒子	孺子
儒子可教	孺子可教
孺子可数	孺子可教
乳臭未乾	乳臭未干
入不付出	入不敷出
入场卷	入场券
入场卷　	入场券
入场权	入场券
入出境管理局	出入境管理局
入谜	入迷
入室N堂	入室升堂
入学考	入学考试
入帐	入账
入坐	入座
蓐疮	褥疮
软臣	软卧
软颚	软腭
软红香土	软红香玉
锐不可挡	锐不可当
润年	闰年
若不胜衣	弱不胜衣
若覆平地	若履平地
若昧平生	素昧平生
若想人不知，除非已莫为	若想人不知，除非己莫为
若要人不知，除非已莫为	若要人不知，除非己莫为
若要人不知除非己莫为	若要人不知，除非己莫为
若要人不知除非已莫为	若要人不知，除非己莫为
偌即偌离	若即若离
偌无其事	若无其事
偌有所思	若有所思
弱不经风	弱不禁风
弱水三千只取一瓢	弱水三千，只取一瓢
S羌	若羌
撒酒风	撒酒疯
撒销	撤销
撒销处分	撤销处分
撒鸭子	撒丫子
撒呓症	撒呓挣
撒营	撤营
撒职	撤职
洒涡	酒窝
萨克司风	萨克斯风
萨克逊人	撒克逊人
萨齐玛	萨其马
萨琪玛	萨其马
塞耳盗锺	塞耳盗钟
塞内加	塞内加尔
塞普路斯	塞浦路斯
塞翁夫马	塞翁失马
塞翁失马焉知非福	塞翁失马，焉知非福
塞翁失马焉知祸福	塞翁失马，焉知祸福
三百Y齑	三百瓮齑
三叉口	三岔口
三朝远老	三朝元老
三寸鸟七寸嘴	三寸鸟，七寸嘴
三迭阳关	三叠阳关
三番四复	三翻四覆
三翻两次	三番两次
三个臭皮匠赛过诸葛亮	三个臭皮匠，赛过诸葛亮
三顾茅芦	三顾茅庐
三级管	三极管
三角架	三脚架
三角三角洲	三角洲
三教几流	三教九流
三军可夺师也，匹夫不可夺志也	三军可夺帅，匹夫不可夺志也
三令五伸	三令五申
三年不窥圆	三年不窥园
三日打鱼两日晒网	三日打鱼，两日晒网
三十六策走为上策	三十六策，走为上策
三十六计走为上计	三十六计，走为上计
三十年河东三十年河西	三十年河东，三十年河西
三天打鱼两天晒网	三天打鱼，两天晒网
三窝两K	三窝两块
三三浴	三衅三浴
三薰三沐	三熏三沐
三折肱为良医	三折肱，为良医
散慢	散漫
散逸	散佚
桑户ㄊ	桑户桊枢
桑椹	桑葚
桑椹儿	桑葚儿
桑枢Y牖	桑枢瓮牖
桑J不徙	桑荫不徙
桑J未移	桑荫未移
嗓音暗哑	嗓音喑哑
搔痒病	瘙痒病
扫地无馀	扫地无余
扫黄打丑	扫黄打非
扫瞄器	扫描器
色采	色彩
色采斑斓	色彩斑斓
色采缤纷	色彩缤纷
色厉内茬	色厉内荏
瑟瑟发料	瑟瑟发抖
杀戳	杀戮
杀费苦心	煞费苦心
杀风景	煞风景
杀时间	霎时间
杀尾	煞尾
杀一警百	杀一儆百
杀一敬百	杀一儆百
沙窗	纱窗
沙锅	砂锅
沙锅浅	砂锅浅
沙壶	砂壶
沙浆	砂浆
沙劳越	沙捞越
沙里掏金	沙里淘金
沙轮机	砂轮机
沙糖	砂糖
沙鱼	鲨鱼
沙憎	沙僧
刹时	霎时
刹时间	霎时间
砂地	沙地
砂块儿	沙块儿
砂箱	沙箱
傻呼呼	傻乎乎
傻冒儿	傻帽儿
啥时侯	啥时候
煞车	刹车
煞车灯	刹车灯
筛撒	筛沙
山查	山楂
山慈菇	山慈姑
山颠	山巅
山洪爆发	山洪暴发
山^水	山^水崖
山栖谷隐	山栖谷饮
山青水秀	山清水秀
山穷水尽无疑路	山穷水尽疑无路
山穷水尽疑无路，柳暗花明又一村	山重水复疑无路，柳暗花明又一村
山ヒ	山淆野
山P海错	山肴海错
山阴道上应接不暇	山阴道上，应接不暇
山之险峻，宁有逾此？	山之险峻，宁有逾此
山中无好汉，猢s称霸王	山中无好汉，猢狲称霸王
山重水复疑无路柳暗花明又一村	山重水复疑无路，柳暗花明又一村
删秋	芟秋
芟荑	芟夷
衫林溪	杉林溪
珊蝴	珊瑚
珊蝴虫	珊瑚虫
珊蝴礁	珊瑚礁
珊珊来迟	姗姗来迟
跚跚来迟	姗姗来迟
风点火	煽风点火
闪烁其辞	闪烁其词
闪铄	闪烁
闪着光采	闪着光彩
扇风点火	煽风点火
善罢干休	善罢甘休
善恶不变	善恶不辨
善价而估	善贾而沽
善于词令	善于辞令
擅解人衣	善解人意
赡仰	瞻仰
商雒	商洛
商品质	商品质量
商确	商榷
商业中心地	商业中心地段
上不着天下不着地	上不着天，下不着地
上簇	上蔟
上窜下跳	上蹿下跳
上方宝剑	尚方宝剑
上方不足下比有余	上方不足，下比有余
上攻受阴	上攻受阻
上颔骨	上颌骨
上交利润	上缴利润
上流社会地	上流社会地位
上天无路入地无门	上天无路，入地无门
上无片瓦下无插针之地	上无片瓦，下无插针之地
上无片瓦下无立锥之地	上无片瓦，下无立锥之地
上帐	上账
尚待商确	尚待商榷
绱鞋	上鞋
梢公	艄公
稍安毋燥	少安毋躁
稍安毋躁	少安毋躁
稍安勿燥	少安毋躁
稍安勿躁	少安毋躁
稍侯	稍候
稍事担搁	稍事耽搁
少安毋燥	少安毋躁
少安勿躁	少安毋躁
少年老诚	少年老成
少少无拘	少小无拘
少壮不努力老大徒伤悲	少壮不努力，老大徒伤悲
少纵即逝	稍纵即逝
奢糜	奢靡
奢糜沉醉	奢靡沉醉
赊帐	赊账
舌敝焦	舌敝唇焦
舌敝枯	舌敝唇枯
舌剑枪	舌剑唇枪
舌剑j	舌剑唇枪
舌桥不下	舌挢不下
蛇化为龙不变其文	蛇化为龙，不变其文
舍得一身剐敢把皇帝拉下马	舍得一身剐，敢把皇帝拉下马
舍身取义	舍生取义
舍生为国	舍身为国
舍已为公	舍己为公
设陷井	设陷阱
社会各届	社会各界
社会午台	社会舞台
社威擅势	摄威擅势
摄相机	摄像机
摄象	摄像
摄象机	摄像机
申敕	申饬
申酉戍亥	申酉戌亥
申张	伸张
申张正义	伸张正义
伸雪	申雪
伸冤	申冤
伸冤理枉	申冤理枉
身分	身份
身分证	身份证
身分证字号	身份证字号
身教胜天言教	身教胜于言教
身坯高大	身材高大
身驱	身躯
身受其害	深受其害
身体嬴弱	身体羸弱
身体赢弱	身体羸弱
身在江湖心存魏阙	身在江湖，心存魏阙
身在江湖心悬魏阙	身在江湖，心悬魏阙
深雠大恨	深仇大恨
深兰	深蓝
深兰色	深蓝色
深情厚意	深情厚谊
深入时机	深入实际
深沈	深沉
深遂	深邃
深为婉惜	深为惋惜
深文傅会	深文附会
深信不移	深信不疑
深醒	深省
神不收舍	神不守舍
神彩	神采
神甫	神父
神鬼叫	神哗鬼叫
神魂荡r	神魂荡漾
神魂撩乱	神魂缭乱
神f气定	神闲气定
神经原	神经元
神密	神秘
神手	身手
神象	神像
神知不清	神志不清
沈佃佃	沉甸甸
沈甸甸	沉甸甸
沈烽静柝	沉烽静柝
沈静寡言	沉静寡言
沈李浮瓜	沉李浮瓜
沈没	沉没
沈闷	沉闷
沈密寡言	沉密寡言
沈默寡言	沉默寡言
沈谋研虑	沉谋研虑
沈谋重虑	沉谋重虑
沈声静气	沉声静气
沈思	沉思
沈思默想	沉思默想
沈思熟虑	沉思熟虑
沈心静气	沉心静气
沈吟不决	沉吟不决
沈吟未决	沉吟未决
沈鱼落雁	沉鱼落雁
沈郁顿挫	沉郁顿挫
沈重	沉重
沈舟破釜	沉舟破釜
沈著地	沉着的
沈著痛快	沉着痛快
沈着痛快	沉着痛快
审判厅	审判庭
审时变势	审时度势
渖阳市	沈阳市
c阳	沈阳
肾功能能不全	肾功能不全
甚获好评	深获好评
甚么	什么
甚至污蔑	甚至诬蔑
渗澹	惨淡
慎密	缜密
慎谋远虑	深谋远虑
慎重追远	慎终追远
生辟	生僻
生活拮倨	生活拮据
生机昂然	生机盎然
生命不息报春不止	生命不息，报春不止
生命倏关	生命攸关
生色俱厉	声色俱厉
生杀于夺	生杀予夺
生死决别	生死诀别
生死有命富贵在天	生死有命，富贵在天
生死至交	生死之交
生造硬作	生造硬做
声名狼籍	声名狼藉
声名雀起	声名鹊起
声色皆厉	声色俱厉
声威大振	声威大震
声闻暇迩	声闻遐迩
声象	声像
声音宏亮	声音洪亮
声誉卓着	声誉卓著
声振九霄	声震九霄
鼬之迳	鼬之径
绳枢Y牖	绳枢瓮牖
绳先启後	绳先启后
省分	省份
省悟	醒悟
省自治区直辖市	各省市自治区
圣诞叶	圣诞夜
圣地牙哥	圣地亚哥
圣弗兰西	圣弗兰西斯科
圣母玛利亚	圣母马利亚
盛名之下其实难副	盛名之下，其实难副
盛宴难再	盛筵难再
剩馀	剩余
菜残羹	剩菜残羹
水残山	剩水残山
尸居馀气	尸居余气
尸禄素{	尸禄素餐
失卷	释卷
失口抵赖	矢口抵赖
失厉	失利
失去光采	失去光彩
失声痛苦	失声痛哭
失之东隅收之桑榆	失之东隅，收之桑榆
失之毫厘谬以千里	失之毫厘，谬以千里
失之毫厘谬之千里	失之毫厘，谬之千里
失之毫，差以千里	失之毫厘，差以千里
失之毫，差之千里	失之毫厘，差之千里
失之毫，谬以千里	失之毫厘，谬以千里
失志不渝	矢志不渝
师老兵破	师老兵疲
诗情大发	诗兴大发
诗书发V	诗书发冢
施不忘报	施不望报
施衿结	施衿结缡
施设	施舍
湿呼呼	湿乎乎
湿渌渌	湿漉漉
岫燃	湿度计
岫绕	湿度器
崃芰艿	湿淋淋的
徜蹁醯	湿漉漉的
十不闲儿	什不闲儿
十二点正	十二点整
十分光采	十分光彩
十分松驰	十分松弛
十锦	什锦
十进值	十进制
十目所视十手所指	十目所视，十手所指
十九稳	十拿九稳
十年生聚十年教训	十年生聚，十年教训
十年树木百年树人	十年树木，百年树人
十日一水五日一石	十日一水，五日一石
十三点正	十三点整
什么时侯	什么时候
什麽	什么
什至	甚至
石膏象	石膏像
石绵	石棉
石绵板	石棉板
石绵瓦	石棉瓦
石沈大海	石沉大海
石碳层	石炭层
石锺乳	石钟乳
石d	石柱
时不我予	时不我与
时侯	时候
时行	时兴
实报实实测	实报实测
实看Υ	实逼处此
实践是检验真理的惟一标准	实践是检验真理的唯一标准
实况报导	实况报道
实象	实像
拾金不味	拾金不昧
拾人唾馀	拾人唾余
拾遗补阙	拾遗补缺
食不裹腹	食不果腹
食不b口	食不糊口
食不厌精脍不厌细	食不厌精，脍不厌细
食不终味	食不重味
食完饭	吃完饭
食鱼遇	食鱼遇鲭
食占不化	食古不化
食子徇君	食子殉君
史丹佛大学	斯坦福大学
史特劳斯	施特劳斯
史无前列	史无前例
矢石不二	矢志不二
豕虎传F	豕虎传讹
使叮当响	使丁当响
使光采	使光彩
使节身分	使节身份
使料不及	始料不及
使松驰	使松弛
使误入岐途	使误入歧途
使心气	使心别气
使心用	使心用幸
使心作	使心作幸
使性テ	使性掼气
使粘结	使黏结
始末原由	始末缘由
始终不逾	始终不渝
始终不遇	始终不渝
始作涌者	始作俑者
始做俑者	始作俑者
屎蚵	屎壳郎
士别三日当刮目相待	士别三日，当刮目相待
士女画	仕女画
士为知己	视为知己
世谷地	世俗地
世界管	世界观
世界联华	世纪联华
世局多变	时局多变
世上无难事只怕有心人	世上无难事，只怕有心人
世外桃园	世外桃源
市场扫瞄	市场扫描
市况报导	实况报道
市民身分	市民身份
示贬於褒	示贬于褒
式样新颍	式样新颖
事必恭亲	事必躬亲
事不迟宜	事不宜迟
事不关己高高挂起	事不关己，高高挂起
事不有馀	事不有余
事得其反	适得其反
事非	是非
事过景迁	事过境迁
事绩	事迹
事实真象	事实真相
事与原违	事与愿违
事在必行	势在必行
侍才傲物	恃才傲物
侍侯	侍候
势不可当	势不可挡
势下两立	势不两立
视如敝徙	视如敝屣
视若合	视若儿戏
视偌罔闻	视若罔闻
视偌无睹	视若无睹
视同合	视同儿戏
视为合	视为儿戏
视阈	视域
试目可待	拭目可待
试目以待	拭目以待
室而人远	室迩人远
室如悬磐	室如悬磬
恃强陵弱	恃强凌弱
是甚么	是什么
是由赞成	是否赞成
嗜酒成僻	嗜酒成癖
誓辞	誓词
m材m所	适材适所
m当其冲	适当其冲
m当其时	适当其时
m得其反	适得其反
m逢其会	适逢其会
m逢其时	适逢其时
m居其反	适居其反
m可而止	适可而止
m情率意	适情率意
m情任欲	适情任欲
m如其分	适如其分
m时应务	适时应务
m俗随时	适俗随时
m心娱目	适心娱目
m性任情	适性任情
m性忘虑	适性忘虑
m以相成	适以相成
噬体	噬菌体
收伏	收服
收a性	收敛性
收茂	收藏
收茂夹	收藏夹
收茂家	收藏家
收茂了	收藏了
收入帐	收入账
收帐	收账
手不失卷	手不释卷
手法主义	守法主义
手痕脚痒	手痛脚痒
手急眼快	手疾眼快
手脚俐落	手脚利落
手脚乾净	手脚干净
手溜弹	手榴弹
手溜弹　	手榴弹
手曲一指	首屈一指
手屈一指	首屈一指
手提带	手提袋
手头宽余	手头宽裕
手午足蹈	手舞足蹈
手足无错	手足无措
手足重茧	手足重趼
守侯	守候
守猎	狩猎
守如处女出如脱兔	守如处女，出如脱兔
守先待後	守先待后
首唱义兵	首倡义兵
首曲一指	首屈一指
首坐	首座
受宠偌惊	受宠若惊
受到积压	受到挤压
受到局限性	受到局限
受庞若惊	受宠若惊
受益非浅	受益匪浅
受益匪浅	受益非浅
受予	授予
受予奖章	授予奖章
受与	授予
受与奖章	授与奖章
兽穷则m	兽穷则啮
授柄於人	授柄于人
授与	授予
授与奖章	授予奖章
授之父母	受之父母
授职惟贤	授职唯贤
瘦骨零丁	瘦骨伶仃
书报滩	书报摊
书厨	书橱
书y子	书呆子
书柬	书简
书生义气	书生意气
书声琅朗	书声琅琅
书声朗朗	书声琅琅
书同文车同轨	书同文，车同轨
书写了草	书写潦草
书扎	书札
倏关	攸关
梳装	梳妆
梳装打扮	梳妆打扮
疏不f亲	疏不间亲
疏球	琉球
舒肝理气	疏肝理气
赎职	渎职
黍秀宫庭	黍秀宫廷
署期	暑期
鼠肚鸡场	鼠肚鸡肠
鼠肝x臂	鼠肝虫臂
鼠目头	鼠目獐头
鼠m虫穿	鼠啮虫穿
鼠mx穿	鼠啮虫穿
鼠m蠹蚀	鼠啮蠹蚀
鼠屎@羹	鼠屎污羹
蜀中无大将廖化作先锋	蜀中无大将，廖化作先锋
曙後星孤	曙后星孤
戍戌	戊戌
戍戌政变	戊戌政变
束手就禽	束手就擒
述而不做	述而不作
树倒猢孙散	树倒猢狲散
树倒猢s散	树倒猢狲散
树懒	树獭
树稍	树梢
树荫	树阴
树荫斑驳	树阴斑驳
树荫凉	树阴凉
树荫凉儿	树阴凉儿
树荫浓郁	树阴浓郁
树指	树脂
恕已及人	恕己及人
恕已及物	恕己及物
数典妄祖	数典忘祖
数东瓜	数冬瓜
数东瓜道茄子	数东瓜，道茄子
数量相待	数量相当
数码像机	数码相机
数奇不遇	数年不遇
数学薄	数学簿
数乙数二	数一数二
刷新纪录	刷新记录
耍尽着数	耍尽招数
耍频嘴	耍贫嘴
耍耍咀皮子	耍耍嘴皮子
衰年幕岁	衰年暮岁
摔不掉	甩不掉
摔交	摔跤
双黄	双簧
双u	双簧
双菅齐下	双管齐下
双重身分	双重身份
双足重茧	双足重趼
谁希罕	谁稀罕
谁言寸草心报得三春晖	谁言寸草心，报得三春晖
水长船高	水涨船高
水滴人穿	水滴石穿
水份	水分
水	水果
水可载舟亦可覆舟	水可载舟，亦可覆舟
水来伸手饭来张口	水来伸手，饭来张口
水笼头	水龙头
水满金山	水漫金山
水密桃	水蜜桃
水磨功夫	水磨工夫
水气腾腾	水汽腾腾
水乳交溶	水乳交融
水上不服	水土不服
水太清则无鱼	水至清则无鱼
水旺旺	水汪汪
水楔不通	水泄不通
水泻不通	水泄不通
水不通	水泄不通
水性扬花	水性杨花
水蒸汽	水蒸气
水中著盐	水中着盐
税捐稽徵	税捐稽征
睡眼朦胧	睡眼蒙
睡眼	睡眼蒙
睡眼惺松	睡眼惺忪
睡眼醒忪	睡眼惺忪
睡眼醒松	睡眼惺忪
顺利成章	顺理成章
顺我者昌逆我者亡	顺我者昌，逆我者亡
顺息万变	瞬息万变
顺之者昌逆之者亡	顺之者昌，逆之者亡
说到作到	说到做到
说慌者	说谎者
说一是一说二是二	说一是一，说二是二
烁石流金	铄石流金
朔本穷源	溯本穷源
嗽叭声	喇叭声
嗽口	漱口
丝竹`弦	丝竹管弦
司各脱	司各特
司空见贯	司空见惯
司马昭之心路人皆知	司马昭之心，路人皆知
私第	私邸
私茂	私藏
私人帐户	私人账户
思辩	思辨
思断义绝	恩断义绝
思将仇报	恩将仇报
思空见惯	司空见惯
思前想後	思前想后
思深义重	恩深义重
思惟	思维
思维定势	思维定式
斯堪地那维亚	斯堪的纳维亚
嘶嘶做声	嘶嘶作声
撕打	厮打
撕杀	厮杀
澌哑的	嘶哑的
死不改诲	死不改悔
死不冥目	死不瞑目
死而後已	死而后已
死kh	死胡同
死灰复然	死灰复燃
死皮癞脸	死皮赖脸
死乞百赖	死乞白赖
死气白赖	死乞白赖
死求百赖	死求白赖
死生有命富贵在天	死生有命，富贵在天
死声G气	死声啕气
死有馀辜	死有余辜
死有馀J	死有余J
死有馀责	死有余责
死有馀诛	死有余诛
死有馀罪	死有余罪
死於非命	死于非命
死在足惜	死不足惜
四不象	四不像
四迭体	四叠体
四海N平	四海升平
四空	司空
四空见惯	司空见惯
四两拔千斤	四两拨千斤
四马难追	驷马难追
四人邦	四人帮
四啼凌空	四蹄凌空
四体不勤五谷不分	四体不勤，五谷不分
四肢打颤	四肢打战
鹿F	簏簌
伺侯	伺候
伺瑕导	伺瑕导n
伺瑕抵	伺瑕抵n
驷马难迫	驷马难追
驷之过	驷之过n
肆无忌殚	肆无忌惮
肆业	肄业
I女痴儿	呆女痴儿
I女痴	呆女痴儿
I女痴男	呆女痴男
I童钝夫	呆童钝夫
松柏长青	松柏常青
松柏後凋	松柏后凋
松驰	松弛
松驰朝纲	松弛朝纲
松驰神经	松弛神经
松驰一下	松弛一下
松塌榻	松塌塌
崧生岳降	嵩生岳降
悚人听闻	耸人听闻
耸然	悚然
诵古非今	颂古非今
颂古诽今	颂古非今
搜岩采	搜岩采干
苏利南	苏里南
苏彝士运河	苏伊士运河
酥油荼	酥油茶
夙敌	宿敌
夙来	素来
夙儒	宿儒
夙兴野寐	夙兴夜寐
夙怨	宿怨
素昧平身	素昧平生
宿诺	夙诺
宿水{风	宿水餐风
宿愿	夙愿
宿愿得偿	夙愿得偿
X	XZ
粟子树	栗子树
塑象	塑像
溯本穷沅	溯本穷源
h{	ht
僳僳族	傈僳族
酸硷度	酸碱度
算无疑策	算无遗策
算帐	算账
算总帐	算总账
虽死之日犹生之年	虽死之日，犹生之年
绥汾河	绥芬河
绥汾河市	绥芬河市
隋阳帝	隋炀帝
随便糟踏	随便糟蹋
随风播落	随风飘落
随风漂荡	随风飘荡
随合	随和
随声附合	随声附和
随世沈浮	随世沉浮
随俗浮沈	随俗浮沉
随俗沈浮	随俗沉浮
随宜	随意
随迂而安	随遇而安
随珠弹雀	隋珠弹雀
随珠和璧	隋珠和璧
岁在龙F	岁在龙蛇
祟高	崇高
祟高志向	崇高志向
谇帚德a	谇帚德锄
碎瓦~垣	碎瓦颓垣
所费不赀	所费不资
所做所为	所作所为
索非亚	索菲亚
索垢檀	索垢寻疵
锁事	琐事
锁碎	琐碎
锁碎小事	琐碎小事
他山之石可以攻玉	他山之石，可以攻玉
它山之石	他山之石
塌实	踏实
H^及米	H糠及米
e冈复岭	沓冈复岭
榻榻实实	踏踏实实
踏故常	踏故习常
踏破铁鞋无觅处得来全不费工夫	踏破铁鞋无觅处，得来全不费工夫
踏心	塌心
踏雪鲟熊	踏雪寻熊
台上一分钟台下十年功	台上一分钟，台下十年功
台帐	台账
抬金不昧	拾金不昧
抬桥	抬轿
苔癣	苔藓
太公钓鱼愿者上钩	太公钓鱼，愿者上钩
太极而否	泰极而否
太然处之	泰然处之
太然自若	泰然自若
太山北斗	泰山北斗
太岁爷上动土	太岁头上动土
太宛转了	太婉转了
态度暖昧	态度暧昧
泰阿倒持	太阿倒持
泰山盘石	泰山磐石
泰唔士	泰晤士
贪得无餍	贪得无厌
贪夫F财	贪夫徇财
贪夫F利	贪夫徇利
贪夫殉财	贪夫徇财
贪夫殉利	贪夫徇利
贪功起	贪功起衅
贪拔搠	贪婪无厌
贪@狼藉	贪污狼藉
贪脏	贪赃
贪脏枉法	贪赃枉法
滩^	滩头
谈不陇	谈不拢
谈笑风声	谈笑风生
痰阙	痰厥
痰阙中风	痰厥中风
坦尚尼亚	坦桑尼亚
坦胸露背	袒胸露背
坦胸露臂	袒胸露臂
炭水化合	碳水化合
炭酸盐	碳酸盐
探勘者	勘探者
唐・吉诃德	唐吉诃德
唐醋	糖醋
唐醋排骨	糖醋排骨
唐棣	棠棣
唐吉柯德	唐吉诃德
唐老鸦	唐老鸭
唐憎	唐僧
堂花	唐花
堂黄	堂皇
堂煌	堂皇
堂吉诃德	唐吉诃德
堂上一呼阶下百诺	堂上一呼，阶下百诺
膛目	瞠目
膛目结舌	瞠目结舌
糖衣h弹	糖衣炮弹
螳臂挡车	螳臂当车
螳螂捕蝉黄雀在后	螳螂捕蝉，黄雀在后
醣厂	糖厂
醣醋	糖醋
醣果	糖果
醣化	糖化
醣浆	糖浆
醣精	糖精
醣类	糖类
醣蜜	糖蜜
醣尿病	糖尿病
醣水	糖水
醣衣	糖衣
倘佯	徜徉
淌水过河	水过河
淌水过去	趟水过去
傥来之物	倘来之物
躺著地	躺着地
趟道	道
趟路	路
|迹匿光	韬迹匿光
掏米	淘米
韬光养诲	韬光养晦
逃之天天	逃之夭夭
桃花讯	桃花汛
桃花园	桃花源
桃李不言下自成蹊	桃李不言，下自成蹊
陶情m性	陶情适性
讨恶翦暴	讨恶剪暴
讨帐	讨账
特别松驰	特别松弛
特别特强调	特别强调
特效	特效药
特徵	特征
梯己	体己
踢键子	踢毽子
啼笑姻缘	啼笑因缘
提拨	提拔
提纲携领	提纲挈领
提纲携领地	提纲挈领地
提壶芦	提葫芦
提练	提炼
题出	提出
题辞	题词
题纲	提纲
题纲挈领	提纲挈领
题名道姓	提名道姓
蹄f三寻	蹄闲三寻
_卉	_雕卉
体态痈肿	体态臃肿
体要	提要
惕励	惕厉
P听远闻	逖听远闻
替古人耽忧	替古人担忧
天崩地折	天崩地坼
天不做美	天不作美
天长久	天长地久
天从人原	天从人愿
天低吴楚眼空无物	天低吴楚，眼空无物
天翻地复	天翻地覆
天份	天分
天侯	天候
天华乱坠	天花乱坠
天机不可泄	天机不可泄露
天气予报	天气预报
天遣	天谴
天燃气	天然气
天如穹隆	天如穹窿
天生我材必有用	天生我才必有用
天时不如地利地利不如人和	天时不如地利，地利不如人和
天随人原	天随人愿
天网灰灰	天网恢恢
天网恢灰	天网恢恢
天网恢恢疏而不漏	天网恢恢，疏而不漏
天下本无事庸人自扰之	天下本无事，庸人自扰之
天下无难事只怕有心人	天下无难事，只怕有心人
天下兴亡匹夫有责	天下兴亡，匹夫有责
天涯海脚	天涯海角
天涯飘泊	天涯漂泊
天有不测风云人有旦夕祸福	天有不测风云，人有旦夕祸福
天折	夭折
天真烂慢	天真烂漫
天真烂熳	天真烂漫
天值地值	天知地知
天竹黄	天竺黄
天姿颍慧	天资颖慧
天姿颖慧	天资颖慧
天资颍慧	天资颖慧
天族地转	天旋地转
添光采	添光彩
添了光采	添了光彩
添校加叶	添枝加叶
添膺	填膺
田菜	甜菜
田梗	田埂
田连仟伯	田连阡陌
田字薄	田字簿
甜密	甜蜜
甜密的梦	甜蜜的梦
甜言密语	甜言蜜语
J菜	甜菜
填l满谷	填坑满谷
填鹰	填膺
忝不知耻	恬不知耻
舔瓜子	甜瓜子
t`	腼腆
tC	腼腆
t颜人世	腆颜人世
t颜事仇	腆颜事仇
挑拔	挑拨
挑拔离间	挑拨离间
挑拨离奸	挑拨离间
挑拨事非	挑拨是非
挑料嘴	挑唇料嘴
挑逗撩拔	挑逗撩拨
挑么挑六	挑幺挑六
挑三捡四	挑三拣四
挑三检四	挑三拣四
挑牙料	挑牙料唇
条分缕拆	条分缕析
条三窝四	挑三窝四
条叶贯	条修叶贯
铁板一K	铁板一块
铁p	铁搭
铁骊	铁力
铁面j牙	铁面枪牙
铁墙铁壁	铜墙铁壁
铁沙掌	铁砂掌
铁树开华	铁树开花
铁靴政策	铁血政策
帖来帖去	贴来贴去
听侯	听候
听会寥寥	听者寥寥
听随尊便	悉听尊便
亭匀	停匀
停火协办	停火协议
婷婷玉立	亭亭玉立
挺而走险	铤而走险
挺胸突肚	挺胸凸肚
通货膨涨	通货膨胀
通辑	通缉
通前彻後	通前彻后
通前澈後	通前澈后
通前至後	通前至后
通窃	通窍
通溶	通融
通统	通通
通M	通脱
通险郴	通险畅机
通霄	通宵
通霄不眠	通宵不眠
通霄不睡	通宵不睡
通霄达旦	通宵达旦
通霄工作	通宵工作
通霄营业	通宵营业
]在抱	恫在抱
同病相连	同病相怜
同尘合@	同尘合污
同仇敌慨	同仇敌忾
同归於尽	同归于尽
同夥	同伙
同流合@	同流合污
同人	同仁
同声相应同气相求	同声相应，同气相求
同是天涯沦落人相逢何必曾相识	同是天涯沦落人，相逢何必曾相识
同心叶力	同心协力
铜铁舌	铜唇铁舌
铜钮扣	铜纽扣
铜山西崩洛钟东应	铜山西崩，洛钟东应
铜圆	铜元
瞳人	瞳仁
统计数料	统计数据
痛苦失声	痛哭失声
痛快沉著	痛快沉着
痛於骨髓	痛于骨髓
偷机	投机
偷机取巧	投机取巧
偷粱换柱	偷梁换柱
偷呕恢	偷梁换柱
合苟从	偷合苟从
合苟容	偷合苟容
头感晕忽	头感晕乎
头上著头	头上着头
头痛医头脚痛医脚	头痛医头，脚痛医脚
头象	头像
投拆	投诉
投机捣把	投机倒把
投机份子	投机分子
投f置散	投闲置散
投闲置敬	投闲置散
透澈	透彻
凸板印刷	凸版印刷
图画薄	图画簿
图们	图门
图穷匕现	图穷匕见
图瓦卢	图瓦鲁
图象	图像
图象处理	图像处理
图象设计	图像设计
图象识别	图像识别
徒废唇舌	徒费唇舌
徒空言	徒托空言
屠戳	屠戮
屠戳无辜	屠戮无辜
屠毒	荼毒
屠龙之计	屠龙之技
土拔鼠	土拨鼠
土地贫脊	土地贫瘠
土圪瘩	土疙瘩
土老冒	土老帽
土鲁番	吐鲁番
土穰细流	土壤细流
土司面包	吐司面包
土着	土著
土着居民	土著居民
吐珠於泽，谁能不含	吐珠于泽，谁能不含
兔缺乌沈	兔缺乌沉
兔头脑	兔头獐脑
抟弄	团弄
推本溯沅	推本溯源
推波助谰	推波助澜
推乾就湿	推干就湿
推委	推诿
推心致腹	推心置腹
推已及人	推己及人
颓丧委靡	颓丧萎靡
退避山舍	退避三舍
退藏於密	退藏于密
退色	褪色
退有後言	退有后言
屯积居奇	囤积居奇
屯	
氽子	汆子
凤攀龙	托凤攀龙
公报私	托公报私
公行私	托公行私
孤寄命	托孤寄命
骥之蝇	托骥之蝇
物陈喻	托物陈喻
物感怀	托物感怀
物连类	托物连类
物引类	托物引类
物寓感	托物寓感
物寓兴	托物寓兴
于空言	托于空言
之空言	托之空言
诸空言	托诸空言
托车	拖车
托辞	托词
托咐	托付
托辣斯	托拉斯
托玛森	托马森
托思沉思	托腮沉思
托斯陀耶夫斯基	妥斯陀耶夫斯基
拖尾峰	拖尾蜂
脱了裤子放屁	脱裤子放屁
脱氧鸟苷	脱氧尿苷
脱颍而出	脱颖而出
驼鸟	鸵鸟
拓补	拓扑
拓城	柘城
拓朴	拓扑
拓朴学	拓扑学
唾面自乾	唾面自干
|不羁	韬不羁
不羁	弛不羁
哇喇	哇啦
挖墙角	挖墙脚
瓦敕	瓦剌
瓦刺	瓦剌
瓦刺势力	瓦剌势力
瓦解冰销	瓦解冰消
瓦影@鱼	瓦影之鱼
歪风斜气	歪风邪气
外电报导	外电报道
外方内员	外方内圆
外中乾	外强中干
外经纬	外经委
外强中乾	外强中干
外鹜	外骛
外园内方	外圆内方
弯曲部份	弯曲部分
蜿蜓起伏	蜿蜒起伏
纨F	纨绔
纨F膏粱	纨绔膏粱
纨F子弟	纨绔子弟
纨裤	纨绔
纨裤子弟	纨绔子弟
纨椅子弟	纨绔子弟
完壁归赵	完璧归赵
完谷不化	顽固不化
玩法徇私	玩法殉私
玩故常	玩故习常
玩皮	顽皮
玩世不公	玩世不恭
玩艺儿	玩意儿
顽固份子	顽固分子
顽耍	玩耍
宛然拒绝	婉然拒绝
宛延	蜿蜒
宛延曲折	蜿蜒曲折
宛言	婉言
宛言拒绝	婉言拒绝
宛言谢绝	婉言谢绝
宛蜒行进	蜿蜒行进
宛转蛾眉	宛转娥眉
挽惜	惋惜
晚霞余辉	晚霞余晖
晚些时侯	晚些时候
婉词	婉辞
婉惜	惋惜
婉延	蜿蜒
婉蜒	蜿蜒
婉蜒曲折	蜿蜒曲折
婉啭	婉转
婉啭悦耳	婉转悦耳
碗豆	豌豆
万般皆下品唯有读书高	万般皆下品，唯有读书高
万分幸庆	万分庆幸
万古常青	万古长青
万古留芳	万古流芳
万户启靡	万户启扉
万赖俱寂	万籁俱寂
万赖无声	万籁无声
万里长征人夫还	万里长征人未还
万绿从中	万绿丛中
万马齐暗	万马齐喑
万马齐	万马齐喑
万码奔腾	万马奔腾
万能五笔	万能无比
万其是	尤其是
万其要	尤其要
万其在	尤其在
万其重要	尤其重要
万倾	万顷
万甚	尤甚
万事具备	万事俱备
万事具备，只欠东风	万事俱备，只欠东风
万事具备只欠东风	万事俱备，只欠东风
万事俱备只欠东风	万事俱备，只欠东风
万事享通	万事亨通
万为突出	尤为突出
万为重要	尤为重要
万文图斯	尤文图斯
万像更新	万象更新
万丈高楼平地而起	万丈高楼，平地而起
万众注目	万众瞩目
D岁允	玩岁允
王後卢前	王后卢前
王岐山	王歧山
网罗人材	网罗人才
网上连邦	网上联邦
往後地	往后地
往来帐单	往来账单
往来帐档	往来账档
往来帐目	往来账目
枉法徇私	枉法殉私
枉法殉私	枉法徇私
枉费舌	枉费唇舌
罔然若失	惘然若失
\W	魍魉
妄费	枉费
妄费心机	枉费心机
妄口巴舌	枉口拔舌
妄狂自大	狂妄自大
妄自匪薄	妄自菲薄
忘杯	忘怀
忘天兴叹	望天兴叹
忘想	妄想
忘言	妄言
忘自非薄	妄自菲薄
忘自菲薄	妄自菲薄
望风披糜	望风披靡
望文生意	望文生义
危如垒卵	危如累卵
危言论	危言核论
危於累卵	危于累卵
威斯康辛州	威斯康星州
威协	威胁
威振天下	威震天下
偎乾就湿	偎干就湿
微波灶	微波炉
微辞	微词
微机四伏	危机四伏
微婉	委婉
微言大意	微言大义
微言大指	微言大旨
煨乾避湿	煨干避湿
煨乾就湿	煨干就湿
巍蛾	巍峨
巍然圪立	巍然屹立
为丛驱	为丛驱雀
为非做歹	为非作歹
为国捐驱	为国捐躯
为虎作猖	为虎作伥
为虎作怅	为虎作伥
为虎作倡	为虎作伥
为虎作仗	为虎作伥
为虎作帐	为虎作伥
为虎做伥	为虎作伥
为虺弗摧为蛇若何	为虺弗摧，为蛇若何
为命是从	唯命是从
为命是听	唯命是听
为人耿值	为人耿直
为人做嫁	为人作嫁
为甚么	为什么
为什麽	为什么
为有牺牲多壮志，敢叫日月换新天	为有牺牲多壮志，敢教日月换新天
为渊驱鱼为丛驱雀	为渊驱鱼，为丛驱雀
围幄	帷幄
围做一团	围作一团
帏幕	帷幕
违法自弊	为法自弊
违心论	唯心论
违心之伦	违心之论
桅竿	桅杆
唯妙唯肖	维妙维肖
唯唯喏喏	唯唯诺诺
唯物辨证	唯物辩证
唯物辨证法	唯物辩证法
帷握	帷幄
惟独	唯独
惟见	唯见
惟见长江天际流	唯见长江天际流
惟精惟一	唯精唯一
惟恐	唯恐
惟恐不及	唯恐不及
惟恐社会	唯恐社会
惟恐天下	唯恐天下
惟恐天下不乱	唯恐天下不乱
惟利是图	唯利是图
惟留	唯留
惟命是从	唯命是从
惟命是听	唯命是听
惟其	唯其
惟所欲为	为所欲为
惟我	唯我
惟我独尊	唯我独尊
惟一不同	唯一不同
惟一出路	唯一出路
惟一方法	唯一方法
惟一条件	唯一条件
惟一途径	唯一途径
惟一要求	唯一要求
惟有	唯有
惟有读书高	唯有读书高
惟有杜康	唯有杜康
惟有牡丹真国色，花开时节动京城	唯有牡丹真国色，花开时节动京城
惟中国人	唯中国人
维基尼亚	维吉尼亚
维几尼亚州	弗吉尼亚州
维命是从	唯命是从
维那斯	维纳斯
维琴尼亚州	弗吉尼亚州
维生物	微生物
维吾儿人	维吾尔人
伟迹	伟绩
尾随钉梢	尾随盯梢
委过	诿过
委过于人	诿过于人
委靡	萎靡
委靡不振	萎靡不振
委屈求全	委曲求全
委宛	委婉
委谢	萎谢
委罪	诿罪
萎顿	委顿
萎糜不振	萎靡不振
猥词	猥辞
痿靡	萎靡
痿靡不振	萎靡不振
韪莫如深	讳莫如深
未卜光知	未卜先知
未竞	未竟
未抿	未泯
未入帐	未入账
未雨绸谬	未雨绸缪
位如志卑	位高志卑
位於	位于
味同嚼腊	味同嚼蜡
胃粘膜	胃黏膜
尉然成风	蔚然成风
喂苦卓绝	艰苦卓绝
慰籍	慰藉
o锋螗斧	猬锋螗斧
o结蚁聚	猬结蚁聚
o起鸡连	猬起鸡连
温家保	温家宝
温情密意	温情蜜意
文采出众	文才出众
文彩	文采
文词	文辞
文风不动	纹风不动
文过是非	文过饰非
文身翦发	纹身剪发
文丝不动	纹丝不动
文武之道一张一弛	文武之道，一张一弛
文章合为时而着，歌诗合为事而作	文章合为时而著，歌诗合为事而作
文章钜公	文章巨公
闻机起舞	闻鸡起舞
闻鸡起午	闻鸡起舞
闻名遐尔	闻名遐迩
闻名暇迩	闻名遐迩
闻在生畏	闻之生畏
蚊过耳	蚊蝇过耳
稳操人券	稳操左券
稳贴	稳帖
问道於盲	问道于盲
问侯	问候
问君能在几多愁	问君能有几多愁
问烁其辞	闪烁其词
汶莱	文莱
翁声翁气	瓮声瓮气
瓮尽杯乾	瓮尽杯干
Y尽杯乾	瓮尽杯干
Y里醯鸡	瓮里醯鸡
Y声Y气	瓮声瓮气
Y天蠡海	瓮天蠡海
Y牖桑枢	瓮牖桑枢
Y牖绳枢	瓮牖绳枢
Y中之鳖	瓮中之鳖
Y中捉鳖	瓮中捉鳖
涡从天降	祸从天降
涡沦	涡轮
涡轮	蜗轮
窝瘪	窝憋
窝瓜	倭瓜
窝茂	窝藏
窝囔	窝囊
蜗行中步	蜗行牛步
卧虎茂龙	卧虎藏龙
卧榻之上岂容他人鼾睡	卧榻之上，岂容他人鼾睡
卧薪胆	卧薪尝胆
握雾云	握雾拿云
乌飞免走	乌飞兔走
乌呼	呜呼
乌喇	乌拉
乌七八槽	乌七八糟
乌烟障气	乌烟瘴气
乌	乌贼
乌孜别克	乌兹别克
乌滋别克	乌孜别克
@泥浊水	污泥浊水
@七八糟	乌七八糟
@手垢面	污手垢面
污七八糟	乌七八糟
污七糟八	乌七八糟
呜枪	鸣枪
屋漏偏逢连夜雨	屋漏偏逢连阴雨
屋上加屋	屋上架屋
屋下盖尾	屋下盖屋
屋下架尾	屋下架屋
无比光采	无比光彩
无齿之尤	无耻之尤
无耻烂言	无耻谰言
无耻滥言	无耻谰言
无耻之犹	无耻之尤
无耻至尤	无耻之尤
无处茂身	无处藏身
无动于中	无动于衷
无动於中	无动于衷
无动於衷	无动于衷
无独有隅	无独有偶
无恶不做	无恶不作
无法想象	无法想像
无关痛养	无关痛痒
无官一身松	无官一身轻
无嵇之谈	无稽之谈
无级变倍	无级变速
无计之谈	无稽之谈
无技可施	无计可施
无济於事	无济于事
无精嗒彩	无精打采
无精打彩	无精打采
无精打睬	无精打采
无可非义	无可非议
无可诽议	无可非议
无可奈何花落去，似曾相似燕	无可奈何花落去，似曾相似燕归来
无可奈何花落去似曾相似燕	无可奈何花落去，似曾相似燕归来
无可柰何	无可奈何
无礼慢骂	无礼谩骂
无礼漫骂	无礼谩骂
无毛大x	无毛大虫
无名贴	无名帖
无明火	无名火
无能无力	无能为力
无宁	毋宁
无任欢迎	无人欢迎
无容置疑地	毋庸置疑地
无上光荣	无尚光荣
无尚	无上
无尚光荣	无上光荣
无是生非	无事生非
无m无莫	无适无莫
无所不致	无所不至
无所m从	无所适从
无所做为	无所作为
无限光采	无限光彩
无懈可占	无懈可击
无银	无垠
无庸	毋庸
无庸讳言	毋庸讳言
无庸置辩	毋庸置辩
无庸置疑	毋庸置疑
无庸赘述	毋庸赘述
无沅之水	无源之水
无缘无悔	无怨无悔
无源之水，无本之本	无源之水，无本之木
无源之水，无本之末	无源之水，无本之木
无源之水无本之木	无源之水，无本之木
无徵不信	无征不信
毋用讳言	无庸讳言
五子	五倍子
五笔划	五笔画
五采	五彩
五采缤纷	五彩缤纷
五彩班斓	五彩斑斓
五彩绚目	五彩炫目
五藏六府	五脏六腑
五藏六腑	五脏六腑
五成谱	五线谱
五尺之僮	五尺之童
五大州	五大洲
五痨七伤	五劳七伤
五文弄墨	舞文弄墨
午弊	舞弊
午台艺术	舞台艺术
午文弄墨	舞文弄墨
午榭歌台	舞榭歌台
武力收伏	武力收服
兀臬	杌陧
勿庸讳言	毋庸讳言
勿庸置疑	毋庸置疑
勿庸赘述	毋庸赘述
戊戍	戊戌
戊戍变法	戊戌变法
阢陧	杌陧
物腐x生	物腐虫生
物侯	物候
物及必反	物极必反
物价爆涨	物价暴涨
物竞大择	物竞天择
物救必反	物极必反
物以类聚人以群分	物以类聚，人以群分
物以希为贵	物以稀为贵
误人之弟	误人子弟
悟会	误会
悟解	误解
国欺君	误国欺君
婺川	务川
雾色蒙	雾色朦胧
夕阳无限好只是近黄昏	夕阳无限好，只是近黄昏
夕阳余辉	夕阳余晖
西窗翦烛	西窗剪烛
西机立断	当机立断
西鹣东l	西鹣东鲽
西茂	西藏
西茂自治区	西藏自治区
吸咽者	吸烟者
希伯来文	希伯莱文
希光	稀光
希贵	稀贵
希罕	稀罕
希罕儿	稀罕儿
希里哗啦	稀里哗啦
希奇	稀奇
希奇古怪	稀奇古怪
希少	稀少
希世	稀世
希世珍品	稀世珍品
希世之宝	稀世之宝
希世之才	稀世之才
希世之珍	稀世之珍
希仪	稀仪
希有	稀有
希有的	稀有的
希珍	稀珍
昔日光采	昔日光彩
析毫剖	析毫剖厘
唏里呼噜	稀里呼噜
唏里哗啦	稀里哗啦
奚幸	
惜世	稀世
惜世之珍	希世之珍
欷[	唏嘘
欷[流涕	唏嘘流涕
萋	奚落
犀顶@文	犀顶龟文
稀亚	西亚
稀粘液	稀黏液
熙来嚷往	熙来攘往
熙嚷	熙攘
熙熙嚷嚷	熙熙攘攘
熙熙壤壤	熙熙攘攘
嘻皮笑脸	嬉皮笑脸
嘻笑	嬉笑
嘻笑怒骂	嬉笑怒骂
嘻笑颜开	喜笑颜开
q动	翕动
嬉嬉哈哈	嘻嘻哈哈
嬉笑颜开	喜笑颜开
肉	息肉
膝行匍伏	膝行匍匐
习字薄	习字簿
席薪枕K	席薪枕块
而不察	习而不察
非成是	习非成是
非成俗	习非成俗
非胜是	习非胜是
惯自然	习惯自然
若自然	习若自然
俗移人	习俗移人
俗移性	习俗移性
为故常	习为故常
焉不察	习焉不察
焉不觉	习焉不觉
焉弗察	习焉弗察
以成性	习以成性
以为常	习以为常
与体成	习与体成
与性成	习与性成
洗炼	洗练
洗水间	洗手间
喜见於色	喜见于色
喜玛拉雅	喜马拉雅
喜雀	喜鹊
喜上眉捎	喜上眉梢
喜形於色	喜形于色
喜孜孜	喜滋滋
喜子	k子
戏管子	戏馆子
戏据性	戏剧性
戏虐	戏谑
戏嘻	嬉戏
细大不逾	细大不渝
细水常流	细水长流
细谈慢说	细谈漫说
细帐	细账
郄诜丹桂	S诜丹桂
郄诜高第	S诜高第
S诜丹桂	郄诜丹桂
S诜高第	郄诜高第
舄卤	卤
呷洛	甘洛
呷呷	嘎嘎
虾蟆	蛤蟆
狭窄部份	狭窄部分
遐不掩瑜	瑕不掩瑜
遐尔闻名	遐迩闻名
拳	划拳
暇不掩瑜	瑕不掩瑜
暇迩	遐迩
暇瑜互见	瑕瑜互见
暇瑜互现	瑕瑜互现
瑕不掩玉	瑕不掩瑜
瑕不R瑜	瑕不掩瑜
霞光消褪	霞光消退
霞光眩目	霞光炫目
下巴颗	下巴颏
下拔	下拨
下败	下拜
下阪走丸	下坂走丸
下笔千言离题万里	下笔千言，离题万里
下不违例	下不为例
下工夫	下功夫
下里匕人	下里巴人
夏x疑冰	夏虫疑冰
夏x语冰	夏虫语冰
仙山琼客	仙山琼阁
仙仙琼阁	仙山琼阁
先断後闻	先断后闻
先法制人	先发制人
先号後庆	先号后庆
先号後笑	先号后笑
先河後海	先河后海
先花後果	先花后果
先来後到	先来后到
先礼後兵	先礼后兵
先难後获	先难后获
先谴队	先遣队
先躯	先驱
先人后已	先人后己
先人後己	先人后己
先声後实	先声后实
先天下之忧而忧后天下之乐而乐	先天下之忧而忧，后天下之乐而乐
先笑後号	先笑后号
先行後闻	先行后闻
先意承旨	先意承志
先意承指	先意承旨
先忧後乐	先忧后乐
先斩後奏	先斩后奏
掀拳裸袖	揎拳有
闲花覆	闲花野草
闲情逸志	闲情逸致
闲歇式	间歇式
闲雅	娴雅
弦律	旋律
贤慧	贤惠
咸与惟新	咸与维新
φ菥	φ鲁毒
涎脸h眼	涎脸饧眼
娴o	娴静
娴	娴习
衔悲菇恨	衔悲茹恨
衔毕佩实	衔华佩实
兔捣鬓	γ捣鬓
显得伶利	显得伶俐
显微摄象	显微摄像
显象	显像
显象管	显像管
险像环生	险象环生
d	险d
N狁	猃狁
现场报导	现场报道
现金出纳帐	现金出纳账
现金帐	现金账
现制性	限制性
陷肼	陷阱
乡壁虚造	向壁虚造
乡音无改鬓毛衰	乡音未改鬓毛衰
相当然	想当然
相得益张	相得益彰
相得益章	相得益彰
相对岫	相对湿度
相互摹仿	相互模仿
相互推委	相互推诿
相矩	相距
相矩不远	相距不远
相w相济	相克相济
相儒以沫	相濡以沫
相视而笑莫逆于心	相视而笑，莫逆于心
相题并论	相提并论
相成风	相习成风
相成俗	相习成俗
相象	相像
相形见黜	相形见绌
相形见细	相形见绌
相形见拙	相形见绌
香纯	香醇
香菰	香菇
详实	翔实
详实记载	翔实记载
详实载记	翔实载记
祥细	详细
享服	享福
享通	亨通
享有声誉	享有盛誉
响彻云宵	响彻云霄
响铛铛	响当当
响	响当当
响和景从	祥和景从
饷y	饷银
想不道	想不到
想往光明	向往光明
想望丰采	想望风采
想象	想像
想象不出	想像不出
想象的	想像的
想象丰富	想像丰富
想象空间	想像空间
想象力	想像力
想象能力	想像能力
想象中	想像中
想象中的	想像中的
想信党	相信党
向後地	向后地
向偶	向隅
向偶而泣	向隅而泣
项练	项链
项庄午剑	项庄舞剑
项庄舞剑意在沛公	项庄舞剑，意在沛公
象不象	像不像
象差	像差
象传	相传
象话	像话
象爬虫	像爬虫
象煞有介事	像煞有介事
象生	像生
象什么似地	像什么似地
象素	像素
象他那样	像他那样
象样	像样
象样的	像样的
象样儿	像样儿
象章	像章
象这样	像这样
象怔主义	象征主义
象徵	象征
象徵性	象征性
象徵主义	象征主义
像胶	橡胶
像貌	相貌
像心m意	像心适意
像形文字	象形文字
像征	象征
削销笔	削铅笔
削趾m屦	削趾适屦
削足m履	削足适履
消防拴	消防栓
消魂	销魂
消极悲极	消极悲观
消谴	消遣
消溶	消融
消声匿迹	销声匿迹
消遥	逍遥
消遥自在地	逍遥自在地
^心Z舌	^心鹂舌
萧洒	潇洒
销货帐	销货账
销	销壳
销歇	消歇
销脏	销赃
销脏灭迹	销赃灭迹
销帐	销账
箫芳芳	萧芳芳
小步午曲	小步舞曲
小部份	小部分
小车不倒尽管推	小车不倒只管推
小儿q痹	小儿麻痹
小幅盘升	小幅攀升
小侯儿	小猴儿
小夥子	小伙子
小砘	小家伙
小腊烛	小蜡烛
小俩口	小两口
小偏宜	小便宜
小气侯	小气候
小时侯	小时候
小题大作	小题大做
小玩艺	小玩意
小玩艺儿	小玩意儿
肖规曹随	萧规曹随
肖墙祸起	萧墙祸起
肖象	肖像
肖象画	肖像画
效犹	效尤
校仇	校雠
校规松驰	校规松弛
笑喝喝	笑呵呵
笑咪咪	笑眯眯
笑容可鞠	笑容可掬
笑涡	笑窝
笑著地	笑着地
啸吒风云	啸咤风云
卵相长	学相长
协从不问	胁从不问
邪门外道	邪门歪道
邪魔歪道	邪魔外道
胁持	挟持
胁肩t足	胁肩累足
胁嫌	挟嫌
胁嫌报复	挟嫌报复
挟肩谄笑	胁肩谄笑
挟天子以令诸候	挟天子以令诸侯
斜气	邪气
缬氨酸	赖氨酸
写字	写字台
卸	卸载
谢霆峰	谢霆锋
邂逅相迂	邂逅相遇
心不在然	心不在焉
心弛神往	心驰神往
心荡神移	心荡神怡
心浮气燥	心浮气躁
心甘情原	心甘情愿
心狠手棘	心狠手辣
心慌撩乱	心慌缭乱
心恢	心灰
心恢意懒	心灰意懒
心火上炎	心火上炙
心惊胆颤	心惊胆战
心旷神移	心旷神怡
心劳日绌	心劳日拙
心律不整	心律不齐
心满原足	心满愿足
心如刀v	心如刀锉
心术不止	心术不正
心无旁鹜	心无旁骛
心细於发	心细于发
心想字成	心想事成
心心相应	心心相印
心移	心怡
心忧未甘	心尤未甘
心犹未甘	心尤未甘
心有余力而不足	心有余而力不足
心有馀悸	心有余悸
心悦成服	心悦诚服
心照不喧	心照不宣
心中偶象	心中偶像
心中无私天地宽	心底无私天地宽
忻忻得意	欣欣得意
辛辛学子	莘莘学子
欣尝	欣赏
新愁旧恨	新仇旧恨
新发於硎	新发于硎
新淦	新干
新罕布夏州	新罕布什尔州
新华社报导	新华社报道
新昏宴尔	新婚宴尔
新疆维吾尔自治区	新疆维吾尔族自治区
新民主义革命	新民主主义革命
新闻报导	新闻报道
新鲜疏菜	新鲜蔬菜
新行势	新形势
新颍	新颖
新喻	新余
新州区	新洲区
薪尽火佳	薪尽火传
馨竹难书	罄竹难书
信而有徵	信而有征
信号肽	信号台
信口开呵	信口开河
信口开合	信口开河
信马游缰	信马由缰
衅发肖墙	衅发萧墙
衅起肖墙	衅起萧墙
稔恶盈	衅稔恶盈
兴废存之	兴废存亡
兴高彩烈	兴高采烈
兴帅问罪	兴师问罪
兴妖做怪	兴妖作怪
星罗旗布	星罗棋布
星欺六	星期六
星星之火可以燎原	星星之火，可以燎原
惺松	惺忪
惺惺做态	惺惺作态
腥风雪雨	腥风血雨
行百里者半於九十	行百里者半于九十
行不改姓坐不改名	行不改姓，坐不改名
行不更名坐不改姓	行不更名，坐不改姓
行成於思	行成于思
行单影只	形单影只
行迹可疑	形迹可疑
行迹无定	形迹无定
行色SS	行色匆匆
行同陌路	形同陌路
行险徼幸	行险侥幸
行M侥幸	行险侥幸
行行色色	形形色色
行有馀力	行有余力
行c	行院
行政区画	行政区划
行踪鬼秘	行踪诡秘
形单影支	形单影只
形容举丧	形容沮丧
形色憔灼	形色焦灼
形相模糊	形象模糊
形像记忆	形象记忆
形像思维	形象思维
型制	形制
型制古朴	形制古朴
醒忪	惺忪
醒松	惺忪
性格粗旷	性格粗犷
性格怪癖	性格怪僻
性格崛强	性格倔强
性情急燥	性情急躁
灾乐祸	幸灾乐祸
凶相必露	凶相毕露
凶涌	汹涌
凶涌澎湃	汹涌澎湃
兄弟阋于墙外御其侮	兄弟阋于墙，外御其侮
芎	芎{
汹酒	酗酒
汹酒滋事	酗酒滋事
汹涌彭湃	汹涌澎湃
汹涌K湃	汹涌澎湃
胸无成府	胸无城府
胸象	胸像
胸有邱壑	胸有丘壑
雄辨	雄辩
雄纠纠	雄赳赳
雄踞一方	雄据一方
雄心豹胆	熊心豹胆
休士顿	休斯敦
休斯顿	休斯敦
修词学	修辞学
修定	修订
修茸	修葺
修茸一新	修葺一新
修息	休息
修养生息	休养生息
修证	修正
羞花闲目	羞花闲月
羞愧难挡	羞愧难当
羞涩蒙	羞涩朦胧
羞于为伍	羞与为伍
辞立诚	修辞立诚
身洁行	修身洁行
朽棘不	朽棘不雕
朽木难	朽木难雕
秀才不出门全知天下事	秀才不出门，全知天下事
秀外惠中	秀外慧中
绣象	绣像
袖手傍观	袖手旁观
溴化乙锭	溴化乙啶
然居首	然举首
虚渡年华	虚度年华
虚怀偌谷	虚怀若谷
虚幻飘渺	虚幻缥缈
虚无漂渺	虚无飘渺
虚无漂缈	虚无飘渺
虚无缥渺	虚无缥缈
虚无飘渺	虚无缥缈
虚无恬	虚无恬淡
虚象	虚像
虚座以待	虚左以待
嘘嘘	吁吁
诩诩如生	栩栩如生
栩诩如生	栩栩如生
序时帐	序时账
叙文	序文
叙言	序言
畜妻养子	蓄妻养子
蓄牧业	畜牧业
轩然人波	轩然大波
宣宾夺主	喧宾夺主
宣染	渲染
暄宾夺主	喧宾夺主
客夺主	喧客夺主
悬灯结采	悬灯结彩
悬B素{	悬B素餐
悬梁刺骨	悬梁刺股
悬建铎	悬鼗建铎
悬峭壁	悬崖峭壁
悬@系鱼	悬龟系鱼
旋涡	漩涡
漩风	旋风
漩流	旋流
漩涡急流	旋涡急流
漩涡险水	旋涡险水
漩涡星云	旋涡星云
选妓徵歌	选妓征歌
选色徵歌	选色征歌
选舞徵歌	选舞征歌
泫然泪下	潸然泪下
]曜	炫耀
炫材扬己	炫才扬己
绚斓	绚烂
绚斓多彩	绚烂多彩
绚丽多采	绚丽多彩
眩碧成p	眩碧成朱
眩目的光	炫目的光
眩目惊心	炫目惊心
眩目震耳	炫目震耳
眩人眼目	炫人眼目
眩耀	炫耀
f材扬己	炫材扬己
f玉贾石	炫玉贾石
f玉求售	炫玉求售
f玉自售	炫玉自售
渲泄	宣泄
靴统	靴筒
学而不思则罔	学而不思则惘
学老於年	学老于年
学然后知不足教然后之困	学然后知不足，教然后之困
学如不及犹恐失之	学如不及，犹恐失之
学识休养	学识修养
学书不成学剑不成	学书不成，学剑不成
踅子	子
雪笳	雪茄
雪笳香烟	雪茄香烟
雪里蕻	雪里红
血红旦白	血红蛋白
血流如柱	血流如注
血青素	血清素
血肉U糊	血肉模糊
血肉相联	血肉相连
谑浪笑敖	谑浪笑傲
熏衣草	薰衣草
薰染	熏染
薰陶	熏陶
寻根究抵	寻根究底
寻欢做乐	寻欢作乐
寻邬	寻乌
寻序	循序
寻序渐进	循序渐进
巡线追踪	循线追踪
询谋谘度	询谋咨度
洵阳	旬阳
荀延残喘	苟延残喘
找	旬邑
循肠	热肠
循规导矩	循规蹈矩
循规蹈距	循规蹈矩
循规距蹈	循规蹈矩
循名实	循名核实
循诵传	循诵习传
循序见进	循序渐进
训服了它	驯服了它
训戒	训诫
训炼	训练
徇国	殉国
徇国忘身	殉国忘身
徇私午弊	徇私舞弊
殉情枉法	徇情枉法
殉情枉心	徇情枉心
殉私	徇私
殉私废公	徇私废公
殉私枉法	徇私枉法
殉私舞弊	徇私舞弊
殉私作弊	徇私作弊
丫鬟	丫环
压宝	押宝
压伏	压服
压仰	压抑
压韵	押韵
压诈	压榨
压诈贫民	压榨贫民
压诈平民	压榨平民
呀呀学语	牙牙学语
鸦鹊无声	鸦雀无声
鸦俗共赏	雅俗共赏
桠杈	丫杈
桠枝	丫枝
胯	丫杈
恐	丫枝
牙尖嘴俐	牙尖嘴利
牙卖加	牙买加
牙隐裂	牙龈裂
哑巴吃黄莲	哑巴吃黄连
哑叭	哑巴
哑吧	哑巴
雅格布森	雅各布森
雅格布逊	雅各布逊
雅鲁茂布江	雅鲁藏布江
雅片	鸦片
雅温得	雅温德
亚里斯多德	亚里士多德
亚力山大	亚历山大
亚细亚州	亚细亚洲
亚洲纪录	亚洲记录
揠旗息鼓	偃旗息鼓
烟波浩淼	烟波浩渺
烟布	烟幕
烟色蒙	烟色朦胧
烟w雨笠	烟蓑雨笠
烟雾蒙	烟雾朦胧
烟雾迷漫	烟雾弥漫
烟	氤氲
淹没不闻	湮没无闻
淹没无闻	湮没无闻
淹淹一息	奄奄一息
闫王好见	阎王好见
严陈以待	严阵以待
严惩不怠	严惩不贷
严辞	严词
严辞回绝	严词回绝
严刑峻罚	严刑峻法
严以律己宽以待人	严以律己，宽以待人
妍红	嫣红
言必信，信必果	言必信，行必果
言必行行必果	言必行，行必果
言不由中	言不由衷
言词	言辞
言多伤	言多伤幸
言骨柳筋	颜骨柳筋
言孜隼	言几析理
言简意该	言简意赅
言简意骇	言简意赅
言近指远	言近旨远
言谈恢谐	言谈诙谐
言者无罪，闻者四月戒	言者无罪，闻者足戒
言者无罪，闻者足诫	言者无罪，闻者足戒
言者无罪闻者足戒	言者无罪，闻者足戒
言者谆谆听者藐藐	言者谆谆，听者藐藐
言之不渝	言之不预
言之无文行而不远	言之无文，行而不远
言之谆谆听之藐藐	言之谆谆，听之藐藐
沿门挂钵	沿门托钵
沿门钵	沿门托钵
沿木求鱼	缘木求鱼
炎皇	炎黄
炎皇子孙	炎黄子孙
研滋截	研几探赜
研孜隼	研几析理
盐硷地	盐碱地
盐硷滩	盐碱滩
盐硷土	盐碱土
阎世锋	阎世铎
阎王好见小鬼难当	阎王好见，小鬼难当
阎王帐	阎王账
颜色降紫	颜色绛紫
偃兵文	偃兵修文
偃苗助长	揠苗助长
掩耳盗锺	掩耳盗钟
掩口葫芦	掩口胡卢
掩茂	掩藏
掩旗息鼓	偃旗息鼓
掩掩一息	奄奄一息
眼不著砂	眼不着砂
眼关四路	眼观四路
眼观鼻鼻观心	眼观鼻，鼻观心
眼观四路耳听八方	眼观四路，耳听八方
眼花潦乱	眼花缭乱
眼花撩乱	眼花缭乱
眼急手快	眼疾手快
眼中钉肉中刺	眼中钉，肉中刺
R口胡卢	掩口胡卢
演讲辞	演讲词
演武修文	偃武修文
演译	演绎
演译归纳	演绎归纳
宴安G毒	宴安鸩毒
宴安鸠毒	宴安鸩毒
晏安G毒	宴安鸩毒
晏会	宴会
艳如桃李冷若冰霜	艳如桃李，冷若冰霜
雁断鱼沈	雁断鱼沉
滟	滟堆
燕安G毒	宴安鸩毒
燕安鸩毒	宴安鸩毒
燕巢於幕	燕巢于幕
燕尔	宴尔
燕尔新婚	宴尔新婚
燕	燕a
燕足M诗	燕足系诗
扬常	扬长
扬常而去	扬长而去
扬清激烛	扬清激浊
扬n	扬榷
羊癫疯	羊癫风
羊很狼贪	羊狠狼贪
羊痫疯	羊痫风
阳关三迭	阳关三叠
杨朱泣岐	杨朱泣歧
杨p泣岐	杨朱泣歧
r汤止沸	扬汤止沸
洋泾滨语	洋泾浜语
洋琴	扬琴
洋菸	洋芋
洋洋得意	扬扬得意
洋洋{{	洋洋洒洒
洋洋自得	扬扬自得
仰臣	仰卧
仰臣起坐	仰卧起坐
仰人鼻总	仰人鼻息
仰事a畜	仰事俯畜
养兵千日用兵一时	养兵千日，用兵一时
养捍老，积Y防饥	养儿待老，积谷防饥
养捍老，积Y防饥	养儿待老，积谷防饥
养悍览	养儿防老
养悍览希积Y防饥	养儿防老，积谷防饥
养虎饴患	养虎遗患
养虎贻患	养虎遗患
养虎自m	养虎自啮
养精畜锐	养精蓄锐
养军千日用在一时	养军千日，用在一时
养痛畜疽	养痛蓄疽
养鹰r去	养鹰扬去
养痈贴患	养痈贻患
养痈贻患	养痈遗患
养子防老，积Y防饥	养子防老，积谷防饥
氧化诰	氧化锆
幺小丑	幺么小丑
夭桃v李	夭桃李
妖治娴都	妖冶娴都
腰支	腰肢
谣言惑众	妖言惑众
摇鼓喙	摇唇鼓喙
摇鼓舌	摇唇鼓舌
摇控	遥控
摇头幌脑	摇头晃脑
摇摇欲堕	摇摇欲坠
遥无音信	杳无音信
遥相互应	遥相呼应
杳无黄鹤	杳如黄鹤
咬文m字	咬文啮字
要功	邀功
要功求赏	邀功求赏
要击	邀击
要末	要么
要想人不知，除非已莫为	要想人不知，除非己莫为
要胁	要挟
要言不繁	要言不烦
要帐	要账
耶酥教	耶稣教
也象	也像
冶练	冶炼
野草f花	野草闲花
野鹤f云	野鹤闲云
野火烧不尽春风吹又生	野火烧不尽，春风吹又生
业精於勤	业精于勤
叶落之秋	叶落知秋
夜朗自大	夜郎自大
夜色蒙胧	褒色朦胧
夜色蒙	夜色朦胧
夜消	夜宵
夜巡K	夜巡游
架之藏	邺架之藏
一班半点	一斑半点
一爆十寒	一暴十寒
一杯黄土	一g黄土
一笔钩断	一笔勾销
一笔抹	一笔抹煞
一笔抹煞	一笔抹杀
一笔抹消	一笔抹杀
一碧万倾	一碧万顷
一鞭先著	一鞭先着
一表人材	一表人才
一表堂堂	仪表堂堂
一波未平一波又起	一波未平，一波又起
一不压众百不随一	一不压众，百不随一
一步一趋	亦步亦趋
一部份	一部分
一差二	一差二误
一倡百和	一唱百和
一倡三叹	一唱三叹
一倡一和	一唱一和
一朝权在手便把令来行	一朝权在手，便把令来行
一愁莫展	一筹莫展
一触既发	一触即发
一蹴而易	一蹴而就
一定份量	一定分量
一方有难，八方支持	一方有难，八方支援
一方有难八方支援	一方有难，八方支援
一佛出世二佛涅	一佛出世，二佛涅
一夫当关，万夫莫当	一夫当关，万夫莫开
一夫当关万夫莫开	一夫当关，万夫莫开
一夫挡关，万夫莫开	一夫当关，万夫莫开
一夫挡关万夫莫开	一夫当关，万夫莫开
一幅对联	一副对联
一杆子插到底	一竿子插到底
一杆子到底	一竿子到底
一个萝卜一个眼	一个萝卜一个坑
一个头两个大	一个头，两个大
一孤之腋	一狐之腋
一古	一股
一古脑	一股脑
一古脑儿	一股脑儿
一股作气	一鼓作气
一鼓做气	一鼓作气
一Y不登	一谷不登
一Y不升	一谷不升
一轰而上	一哄而上
一弘清泉	一泓清泉
一{而散	一哄而散
一火	一伙
一夥人	一伙人
一见顷心	一见倾心
一见衷情	一见钟情
一见锺情	一见钟情
一箭双m	一箭双雕
一将功成万古枯	一将功成万骨枯
一颗红心两种准备	一颗红心，两种准备
一口同声	异口同声
一浊Ы	一壶千金
一览无馀	一览无余
一劳永易	一劳永逸
一雷惊蜇	一雷惊蛰
一麟半爪	一鳞半爪
一溜湮	一溜烟
一码当先	一马当先
一码领先	一马领先
一脉相成	一脉相承
一面之辞	一面之词
一命鸣呼	一命呜呼
一命呜乎	一命呜呼
一年被蛇咬十年怕井绳	一年被蛇咬，十年怕井绳
一诺千斤	一诺千金
一拍即和	一拍即合
一挂恍	一颦一笑
一曝十寒	一暴十寒
一乾二净	一干二净
一切就序	一切就绪
一窃不通	一窍不通
一丘之骆	一丘之貉
一邱之貉	一丘之貉
一去不复反	一去不复返
一犬吠形百犬吠声	一犬吠形，百犬吠声
一人传虚万人传实	一人传虚，万人传实
一人得道鸡犬升天	一人得道，鸡犬升天
一人善射百夫决拾	一人善射，百夫决拾
一人之下万人之上	一人之下，万人之上
一人做事，一人担	一人做事一人担
一日不见如隔三秋	一日不见，如隔三秋
一日万	一日万几
一如即往	一如既往
一如继往	一如既往
一生不吭	一声不吭
一手独拍虽疾无声	一手独拍，虽疾无声
一手交钱一手交货	一手交钱，一手交货
一树百	一树百获
一丝不荀	一丝不苟
一塌胡涂	一塌糊涂
一榻胡涂	一塌糊涂
一榻糊涂	一塌糊涂
一踏糊涂	一塌糊涂
一蹋糊涂	一塌糊涂
一台手机	一个手机
一条面包	一个面包
一望无银	一望无垠
一窝风	一窝蜂
一相情愿	一厢情愿
一厢情原	一厢情愿
一言不和	一言不合
一言而蔽之	一言一蔽之
一言即出，驷马难追	一言既出，驷马难追
一言既出驷马难追	一言既出，驷马难追
一叶蔽目不见泰山	一叶蔽目，不见泰山
一叶障目不见泰山	一叶障目，不见泰山
一夜知秋	一叶知秋
一一例举	一一列举
一以惯之	一以贯之
一应具全	一应俱全
一则以喜一则以惧	一则以喜，一则以惧
一张一驰	一张一弛
一张一驰，文武之道	一张一弛，文武之道
一招不慎满盘皆输	一招不慎，满盘皆输
一枕黄梁	一枕黄粱
一支花	一枝花
一至於此	一至于此
一至於斯	一至于斯
一炷香	一柱香
一着	一招
一着被蛇咬三年怕井绳	一着被蛇咬，三年怕井绳
一着不慎，全盘皆输	一招不慎，全盘皆输
一着不慎满盘皆输	一着不慎，满盘皆输
一子出家，七祖N天	一子出家，七祖升天
一字千斤	一字千金
伊比利半岛	伊比利亚半岛
伊尔库次克	伊尔库茨克
伊和路	伊河路
伊莉莎白	伊丽莎白
伊利诺伊州	伊利诺斯州
伊於胡底	伊于胡底
衣不敝体	衣不蔽体
衣带渐宽终不悔为伊消得人憔悴	衣带渐宽终不悔，为伊消得人憔悴
衣勾	衣钩
衣冠辐凑	衣冠辐辏
衣冠蓝缕	衣冠褴褛
衣冠绪馀	衣冠绪余
衣冠V	衣冠冢
衣衿	衣襟
衣锦衣	衣锦N衣
衣掷堵	衣竹荞
衣来伸手饭来张口	衣来伸手，饭来张口
衣衫蓝缕	衣衫褴褛
衣衫烂缕	衣衫褴褛
衣随	依随
衣著	衣着
衣著华丽	衣着华丽
衣著华美	衣着华美
衣著简朴	衣着简朴
衣著朴素	衣着朴素
衣著鲜丽	衣着鲜丽
依H附木	依草附木
依法h制	依法炮制
依胡芦画瓢	依葫芦画瓢
依经傍]	依经傍注
依老卖老	倚老卖老
依丽莎白	伊丽莎白
依妹儿	伊妹儿
依山而据	依山而居
壹败涂地	一败涂地
壹倡三叹	一唱三叹
怡人口实	贻人口实
怡笑大方	贻笑大方
姨父	姨夫
贻患	遗患
贻患无穷	遗患无穷
贻患终身	遗患终身
移译	译
移就教	移樽就教
遗德馀烈	遗德余烈
遗恩馀烈	遗恩余烈
遗芳馀烈	遗芳余烈
遗芬馥	遗芬剩馥
遗芬馀荣	遗芬余荣
遗风遗译	遗风遗泽
遗风馀采	遗风余采
遗风馀教	遗风余教
遗风馀烈	遗风余烈
遗风馀思	遗风余思
遗风馀俗	遗风余俗
遗风馀	遗风余习
遗风馀象	遗风余象
遗风馀韵	遗风余韵
遗风馀泽	遗风余泽
遗害	贻害
遗害无穷	贻害无穷
遗惠馀泽	遗惠余泽
遗孽馀烈	遗孽余烈
遗人口实	贻人口实
遗声馀价	遗声余价
遗失独立	遗世独立
遗误	贻误
遗误后学	贻误后学
遗误农时	贻误农时
遗误战机	贻误战机
遗象	遗像
遗笑	贻笑
遗笑大方	贻笑大方
遗休馀烈	遗休余烈
遗训馀风	遗训余风
遗音馀韵	遗音余韵
遗珠弃壁	遗珠弃璧
颐合园	颐和园
疑人勿用用人勿疑	疑人勿用，用人勿疑
疑则勿用用则勿疑	疑则勿用，用则勿疑
已诚相待	以诚相待
已此为荣	以此为荣
已次充好	以次充好
已德报怨	以德报怨
已法治税	以法治税
已防不测	以防不测
已防万一	以防万一
已工补农	以工补农
已工代赈	以工代赈
已观后效	以观后效
已假乱真	以假乱真
已旧换新	以旧换新
已礼相待	以礼相待
已利再战	以利再战
已少胜多	以少胜多
已身殉职	以身殉职
已胜利而告终	以胜利而告终
已失败而告终	以失败而告终
已势压人	以势压人
已所不欲	己所不欲
已所不欲，勿施于人	己所不欲，勿施于人
已小见大	以小见大
已逸待劳	以逸待劳
已赢利为目的	以赢利为目的
已资鼓励	以资鼓励
以暴治暴	以暴制暴
以冰止蝇	以冰致蝇
以代	以待
以丰补欠	以丰补歉
以付养农	以副养农
以骨去	以骨去蚁
以观後效	以观后效
以`窥天	以管窥天
以极	以及
以儆效犹	以儆效尤
以敬效尤	以儆效尤
以老卖老	倚老卖老
以至鼠	以狸至鼠
以励再战	以利再战
以例说明	举例说明
以命相拚	以命相拼
以沫相儒	以沫相濡
以偏赅全	以偏概全
以偏盖全	以偏概全
以其昏昏使人昭昭	以其昏昏，使人昭昭
以其人之道，还治其人身	以其人之道，还治其人之身
以其人之道还治其人之身	以其人之道，还治其人之身
以肉]虎	以肉喂虎
以身作责	以身作则
以身做则	以身作则
以j撞锺	以j撞钟
以铜为鉴可以正衣冠	以铜为鉴，可以正衣冠
以为後图	以为后图
以郄视文	以S视文
以限还眼，以牙还牙	以眼还眼，以牙还牙
以小人之心度君子之腹	以小人之心，度君子之腹
以言徇物	以言殉物
以眼还眼以牙还牙	以眼还眼，以牙还牙
以噎废{	以噎废餐
以已度人	以己度人
以逸代劳	以逸待劳
以致于	以至于
以锥{	以锥餐壶
以子之矛攻子之盾	以子之矛，攻子之盾
以紫乱p	以紫乱朱
以紫为p	以紫为朱
倚傍	依傍
倚傍门户	依傍门户
倚草附木	依草附木
倚赖	依赖
倚赖成性	依赖成性
倚强凌弱	以强凌弱
倚山傍水	依山傍水
义不容词	义不容辞
义大利	意大利
义大利半岛	意大利半岛
义大利人	意大利人
义大利王国	意大利王国
义愤添膺	义愤填膺
义愤填鹰	义愤填膺
义气风发	意气风发
义气相投	意气相投
义气用事	意气用事
义万富翁	亿万富翁
义无返顾	义无反顾
义险固守	以险固守
义形於色	义形于色
义债累累	负债累累
义正辞严	义正词严
义正严词	义正词严
亦或	抑或
异彩分呈	异彩纷呈
异曲同功	异曲同工
抑扶弱	抑强扶弱
抑杨顿挫	抑扬顿挫
易如翻掌	易如反掌
易阳县	宜阳县
易於反掌	易于反掌
易於拾遗	易于拾遗
悒郁寡欢	抑郁寡欢
益智养成	益智养神
逸趣横生	异趣横生
逸兴惴飞	逸兴湍飞
意料之处	意料之外
意昧着	意味着
意前笔後	意前笔后
意然决然	毅然决然
意谓着	意味着
意尤未尽	意犹未尽
溢采流光	溢彩流光
溢於言表	溢于言表
溢於言外	溢于言外
肄无忌惮	肆无忌惮
毅然诀然	毅然决然
因才施教	因材施教
因小失人	因小失大
因咽废食	因噎废食
阴庇	荫庇
阴蔽	荫蔽
阴	阴唇
阴凉处	荫凉处
阴谋鬼计	阴谋诡计
阴沈地	阴沉地
阴翳	荫翳
阴着儿	阴招儿
姻亚	姻娅
音象	音像
氤氲a	氤氲
s	氤氲
@	殷勤
银行存摺	银行存折
银行帐号	银行账号
银行帐户	银行账户
银样蜡枪头	银样J枪头
银样n枪头	银样J枪头
银圆	银元
夤吃卯粮	寅吃卯粮
霪雨	淫雨
尹凤岐	尹凤歧
引进人材	引进人才
引亢	引吭
引亢高歌	引吭高歌
引入岐途	引入歧途
引伸	引申
引伸触类	引申触类
引伸义	引申义
饮G止渴	饮鸩止渴
饮鸠止渴	饮鸩止渴
饮水思沅	饮水思源
隐括	a栝
隐茂	隐藏
隐茂着	隐藏着
隐慝	隐匿
隐慝实情	隐匿实情
隐土	隐士
隐性埋名地	隐姓埋名地
瘾君子	隐君子
印地安纳	印第安纳
印地安纳州	印第安纳州
印地安人	印第安人
印第安	印地安
J子封妻	荫子封妻
应酬漩涡	应酬旋涡
应付帐款	应付账款
应接不遐	应接不暇
应接不瑕	应接不暇
应生虫	应声虫
应收帐单	应收账单
应收帐款	应收账款
英磅	英镑
英汉辞典	英汉词典
英特网	因特网
英雄倍出	英雄辈出
英雄气慨	英雄气概
英语薄	英语簿
英姿换发	英姿焕发
英姿涣发	英姿焕发
莺歌燕午	莺歌燕舞
莺吟燕	莺吟燕舞
嘤其鸣矣求其友声	嘤其鸣矣，求其友声
罂粟科	罂粟壳
膺品	赝品
鹰勾鼻	鹰钩鼻
迎侯	迎候
迎头敢上	迎头赶上
迎头s上	迎头赶上
盈利能力	赢利能力
盈利性	赢利性
盈馀	盈余
荧火虫	萤火虫
萤光	荧光
萤光灯	荧光灯
萤光镜	荧光镜
萤光幕	荧光幕
萤光素	荧光素
营利性	赢利性
营私午弊	营私舞弊
营私舞敝	营私舞弊
营私舞蔽	营私舞弊
营营苟苟	蝇营狗苟
蝇萦狗苟	蝇营狗苟
嬴弱	羸弱
赢弱	羸弱
赢余	盈余
颖河路	颍河路
影蝶机	影碟机
影象	影像
影影踔踔	影影绰绰
映象	映像
硬帮帮	硬邦邦
硬梆梆	硬邦邦
硬拚	硬拼
硬臣	硬卧
硬磐	硬盘
拥包	拥抱
拥_救火	拥彗救火
拥金	佣金
痈肿	臃肿
庸录	庸碌
庸容大度	雍容大度
庸庸录录	庸庸碌碌
庸庸碌录	庸庸碌碌
庸中皎皎	庸中佼佼
雍荣华贵	雍容华贵
雍荣闲雅	雍容娴雅
雍荣雅步	雍容雅步
雍容f雅	雍容闲雅
雍容闲雅	雍容娴雅
永保青春	永葆青春
永往	勇往
永往直前	勇往直前
永无止尽	永无止境
用功夫	用工夫
用什麽	用什么
用无线电通讯	无线电通讯
优待俘掳	优待俘虏
优患余生	忧患余生
优会价	优惠价
优贤r历	优贤扬历
优游岁月	悠悠岁月
优游自m	悠游自适
优游自在	悠游自在
优哉优哉	优哉悠哉
优哉游哉	优哉悠哉
忧患馀生	忧患余生
忧柔	优柔
忧柔寡断	优柔寡断
忧心重重	忧心忡忡
攸哉游哉	优哉优哉
幽曲黯味	幽曲黯昧
幽闲	悠闲
悠柔寡断	优柔寡断
悠哉悠哉	优哉优哉
悠哉游哉	优哉悠哉
尤如猛虎下山	犹如猛虎下山
由然而生	油然而生
由於	由于
犹犹予予	犹犹豫豫
犹予不决	犹豫不决
油菜子	油菜籽
油咀滑舌	油嘴滑舌
油茂	油藏
油乾灯尽	油干灯尽
油乾火尽	油干火尽
油嘴花	油嘴花唇
游刃有馀	游刃有余
游刃馀地	游刃余地
游手好f	游手好闲
游手偷f	游手偷闲
友坂理惠	友阪理惠
有可乘	有n可乘
有持无恐	有恃无恐
有胆有实	有胆有识
有个交代	有个交待
有咀无心	有嘴无心
有亏职守	有愧职守
有朋自远来，不亦乐乎	有朋自远方来，不亦乐乎
有色眼睛	有色眼镜
有身分	有身份
有甚么	有什么
有声力量	有生力量
有失身分	有失身份
有时侯	有时候
有所尊循	有所遵循
有所做为	有所作为
有条不纹	有条不紊
有一分热发一分光	有一分热，发一分光
有缘无份	有缘无分
有则改之，无则加免	有则改之，无则加勉
有则改之无则加勉	有则改之，无则加勉
有粘性	有黏性
有粘性的	有黏性的
有张有驰	有张有弛
有志者事竞成	有志者事竟成
又脏又嗅	又脏又臭
右军气	右军习气
右顷	右倾
右手画圆左手画方	右手画圆，左手画方
幼雅	幼稚
幼雅可笑	幼稚可笑
蚴黑	黝黑
纡回	迂回
纡青紫	纡青拖紫
纡p怀金	纡朱怀金
纡p拖紫	纡朱拖紫
纡p曳紫	纡朱曳紫
迂徊渐进	迂回渐进
迂徊战术	迂回战术
迂人不淑	遇人不淑
迂水搭桥	遇水搭桥
渝期	逾期
渝期作废	逾期作废
于阗	于田
予测予测	预测预测
予防医学家	预防医学家
余辉	余晖
余辉映照	余晖映照
余年无多	馀年无多
余音	余音袅袅
余音绕粱	余音绕梁
余勇可嘉	余勇可贾
於安思危	于安思危
於此	于此
於乎	呜呼
於呼哀哉	呜呼哀哉
於是	于是
於戏	呜呼
鱼产	渔产
鱼场	渔场
鱼船	渔船
鱼村	渔村
鱼鼓	渔鼓
鱼鼓道情	渔鼓道情
鱼贯而人	鱼贯而入
鱼具	渔具
鱼目混	鱼目混珍
鱼水相	鱼水相欢
鱼网	渔网
鱼网鸿罹	鱼网鸿离
鱼网纹	渔网纹
鱼鲜晕腥	鱼鲜荤腥
鱼业	渔业
鱼游濠上	鱼游壕上
鱼游鞲	鱼游焦釜
俞墙钻隙	逾墙钻隙
馀杯冷炙	余杯冷炙
馀风遗文	余风遗文
馀妙绕梁	余妙绕梁
馀声三日	余声三日
馀响绕梁	余响绕梁
馀兴	余兴
馀腥残秽	余腥残秽
馀音绕梁	余音绕梁
馀勇可贾	余勇可贾
馀韵流风	余韵流风
馀子碌碌	余子碌碌
渔网鸿离	鱼网鸿离
渔汛	鱼汛
雩都	于都
逾墙窥	逾墙窥n
逾墙钻	逾墙钻n
愚味	愚昧
愚味无知	愚昧无知
愚者千虑必有一得	愚者千虑，必有一得
瑜不R瑕	瑜不掩瑕
与其杀是僮孰若卖之	与其杀是僮，孰若卖之
与其坐而待亡孰若起而拯之	与其坐而待亡，孰若起而拯之
与人方便自己方便	与人方便，自己方便
与日具增	与日俱增
与身具来	与身俱来
与生具来	与生俱来
与世沈浮	与世沉浮
羽林军	御林军
羽扇伦巾	羽扇纶巾
雨打巴焦	雨打芭蕉
雨过天青	雨过天晴
雨後春笋	雨后春笋
雨淋日	雨淋日晒
雨声嘀嗒	雨声滴答
雨声滴嗒	雨声滴答
雨声浙沥	雨声淅沥
语辞	语词
语惊四坐	语惊四座
语颇镌永	语颇隽永
语无仑次	语无伦次
语无论次	语无伦次
玉迟临风	玉树临风
玉厄无当	玉卮无当
玉个大帝	玉皇大帝
玉蛄琼浆	玉液琼浆
玉箫金g	玉箫金管
驭夫有术	御夫有术
预会	与会
预激综合症	预激综合征
预闻	与闻
欲盖弥章	欲盖弥彰
欲加之罪何患无辞	欲加之罪，何患无辞
欲穷千里目更上一层楼	欲穷千里目，更上一层楼
欲要人不知除非己莫为	欲要人不知，除非己莫为
喻意	喻义
御手	驭手
裕後光前	裕后光前
遇难成详	遇难呈祥
豫备	预备
豫防	预防
豫感	预感
豫期	预期
鹬蚌持争渔翁得利	鹬蚌持争，渔翁得利
鹬蚌相持渔翁得利	鹬蚌相持，渔翁得利
鹬蚌相争渔人得利	鹬蚌相争，渔人得利
鹬蚌相争渔翁得利	鹬蚌相争，渔翁得利
鬻矛誉J	鬻矛誉盾
c林	玉林
冤有头债有主	冤有头，债有主
渊清玉e	渊清玉洁
渊沅流长	源远流长
渊源流长	源远流长
元本	原本
元来	原来
元煤	原煤
元霄节	元宵节
元鱼	鼋鱼
元元本本	原原本本
员林	园林
园形	圆形
园凿方纳	圆凿方枘
园凿方枘	圆凿方枘
园锥曲线	圆锥曲线
沅清流洁	源清流洁
沅沅本本	原原本本
沅沅不断	源源不断
沅沅不竭	源源不竭
沅沅不绝	源源不绝
沅沅而来	源源而来
沅沅流长	源远流长
原驰蜡象	原驰蜡像
原故	缘故
原配	元配
原气	元气
原气大伤	元气大伤
原物壁还	原物璧还
原形必露	原形毕露
原由	缘由
原子幅射	原子辐射
援茂	援藏
缘份	缘分
缘来是你	原来是你
缘悭分线	缘悭分浅
缘a分浅	缘悭分浅
缘a一面	缘悭一面
源本	原本
源源本本	原原本本
圜凿方枘	圆凿方枘
怨家对头	冤家对头
怨家债主	冤家债主
怨天万人	怨天尤人
怨天忧人	怨天尤人
怨天由人	怨天尤人
怨天犹人	怨天忧人
怨由	怨尤
怨怨相报	冤冤相报
院不愿	愿不愿
约翰尼斯堡	约翰内斯堡
约翰施特劳斯	约翰・施特劳斯
约莫	约摸
月光蒙	月光朦胧
月光溶容	月光溶溶
月浩清辉	月皓清辉
月落星沈	月落星沉
月明星希	月明星稀
月色蒙	月色朦胧
月蚀	月食
月下老	月下老儿
月晕A润	月晕础润
刖趾m屦	刖趾适屦
越徂代庖	越俎代庖
越过漩涡	越过旋涡
越阻代庖	越俎代庖
a地呼天	龠地呼天
云豆	芸豆
云暝碌	云阶月地
纭纭众生	芸芸众生
陨殁	殒殁
殒落	陨落
运筹画策	运筹划策
运筹围幄	运筹帷幄
运筹帏幄	运筹帷幄
运筹唯幄	运筹帏幄
运筹唯握	运筹帏幄
运筹帷握	运筹帷幄
运筹惟幄	运筹帏幄
运筹维幄	运筹帏幄
运用之妙，存于一心	运用之妙，存乎一心
运用之妙存乎一心	运用之妙，存乎一心
运用之妙存于一心	运用之妙，存乎一心
晕忽	晕乎
晕糊	晕乎
晕腥	荤腥
晕晕糊糊	晕晕乎乎
酝藉	蕴藉
藉	蕴藉
韫X藏珠	韫椟藏珠
韫X而藏	韫椟而藏
蕴茂	蕴藏
蕴茂量	蕴藏量
蕴茂着	蕴藏着
蕴酿	酝酿
蕴育	孕育
咂嘴弄	咂嘴弄唇
咂嘴舔	咂嘴舔唇
杂贷	杂货
杂脍	杂烩
杂揉	杂糅
杂e	杂沓
砸咀弄舌	咂嘴弄舌
载歌载午	载歌载舞
载自匦	载欢载笑
再穿著	再穿着
再放异采	再放异彩
再接再历	再接再厉
再接再励	再接再厉
再接再砺	再接再厉
再生能沅	再生能源
再做冯妇	再作冯妇
在家靠父母，出外靠朋友	在家靠父母，出门靠朋友
在人矮檐下怎敢不低头	在人矮檐下，怎敢不低头
在特在通常情况下	在通常情况下
在这个时侯	在这个时候
在坐	在座
簪笔罄折	簪笔磬折
赃贿狼籍	赃贿狼藉
赃乱	脏乱
赃乱现象	脏乱现象
赃私狼籍	赃私狼藉
赃@狼藉	赃污狼藉
赃污狼籍	赃污狼藉
臧Y亡羊	臧谷亡羊
脏官污吏	赃官污吏
脏款	赃款
脏钱	赃钱
脏钱害身	赃钱害身
脏物	赃物
脏物归公	赃物归公
脏稀稀	脏兮兮
糟塌	糟蹋
糟踏	糟蹋
凿柄	凿枘
早些时侯	早些时候
早知今日何必当初	早知今日，何必当初
早知今日悔不当初	早知今日，悔不当初
枣类植物	藻类植物
澡类学	藻类学
o白不分	皂白不分
o白沟分	皂白沟分
o白难分	皂白难分
o丝麻线	皂丝麻线
造端始	造端托始
造就人材	造就人才
造谋布	造谋布阱
造象	造像
造形艺术	造型艺术
造谣污蔑	造谣诬蔑
造谣中尚	造谣中伤
噪刮	噪聒
燥动	躁动
燥急	躁急
躁热	燥热
躁热异常	燥热异常
躁之过急	操之过急
责责	啧啧
v舌缄	v舌缄唇
怎麽	怎么
增溶	增容
增与	赠与
咋咋唬唬	咋咋呼呼
记	札记
扎根串连	扎根串联
扎记	札记
扎以尔	扎伊尔
铡门	闸门
乍暧还寒	乍暖还寒
斋粉	齑粉
债卷	债券
沾花惹草	拈花惹草
沾污清白	玷污清白
沾沾自f	沾沾自炫
粘稠	黏稠
粘稠的	黏稠的
粘而不腻	黏而不腻
粘附分子	黏附分子
粘合斑	黏合斑
粘合而成	黏合而成
粘合在一起	黏合在一起
粘合着	黏合着
粘乎乎	黏乎乎
粘糊	黏糊
粘糊糊	黏糊糊
粘糊糊的	黏糊糊的
粘花惹草	拈花惹草
粘化	黏化
粘结地	黏结地
粘结剂	黏结剂
粘结性	黏结性
粘菌的	黏菌的
粘米	黏米
粘膜免疫	黏膜免疫
粘膜炎	黏膜炎
粘皮著骨	粘皮着骨
粘亲带故	沾亲带故
粘土	黏土
粘团	黏团
粘涎	黏涎
粘性	黏性
粘性之物	黏性之物
粘液	黏液
粘液菌	黏液菌
粘液囊	黏液囊
粘液素	黏液素
粘液性水肿	黏液性水肿
粘液质	黏液质
粘质物	黏质物
粘著	黏着
粘著性	黏着性
粘着地	黏着地
粘着剂	黏着剂
粘着力	黏着力
粘着性	黏着性
粘着语	黏着语
稚贤厦	毡上拖毛
瞻顾前後	瞻顾前后
瞻前顾後	瞻前顾后
瞻前忽後	瞻前忽后
瞻前思後	瞻前思后
瞻养	赡养
瞻养父母	赡养父母
斩新	崭新
展开竟赛	展开竞赛
展开想象	展开想像
展露头角	崭露头角
展转	辗转
展转反侧	辗转反侧
崭露头脚	崭露头角
辗毙	碾毙
辗成	碾成
辗米	碾米
辗平	碾平
辗轧声	碾轧声
占居优势	占据优势
战鼓冬冬	战鼓咚咚
战战遑遑	战战惶惶
张驰	张弛
张驰有度	张弛有度
张植髭	张唇植髭
张大其辞	张大其词
张灯结采	张灯结彩
张慌	张皇
张慌失措	张皇失措
张惶失措	张皇失措
张袂成荫	张袂成阴
张牙午爪	张牙舞爪
张牙舞瓜	张牙舞爪
章节按排	章节安排
彰明较着	彰明较著
彰明校著	彰明较著
头鼠目	獐头鼠目
仗义输财	仗义疏财
仗义直言	仗义执言
帐本	账本
帐簿	账簿
帐册	账册
帐单	账单
帐房	账房
帐房先生	账房先生
帐号	账号
帐户	账户
帐款	账款
帐面	账面
帐面价值	账面价值
帐目	账目
帐蓬	帐篷
帐上	账上
帐头	账头
帐务	账务
帐主子	账主子
招魂扬播	招魂扬幡
招聘启示	招聘启事
招术用尽	招数用尽
招贤纳上	招贤纳士
招摇装骗	招摇撞骗
招之即来	召之即来
找碴儿	找茬儿
找岔	找茬
召之既来	召之即来
照插不误	照查不误
照胡芦画瓢	照葫芦画瓢
照像	照相
照像机	照相机
蜇伏	蛰伏
遮避	遮蔽
遮避风寒	遮蔽风寒
遮前掩後	遮前掩后
遮天避日	遮天蔽日
遮掩法	遮眼法
遮阳蓬	遮阳篷
折迭	折叠
折洗缝连	拆洗缝连
摺叠为	折叠为
辙乱缑	辙乱旗靡
这到不错	这倒不错
这个时侯	这个时候
这麽	这么
这末	这么
这时侯	这时候
浙沥	淅沥
针贬	针砭
针贬时弊	针砭时弊
针打印机	针式打印机
针角细密	针脚细密
针孔照像机	针孔照相机
针眨	针砭
针眨时弊	针砭时弊
针炙	针灸
针炙疗法	针灸疗法
针状吻	针状物
珍茂	珍藏
珍羞	珍馐
真工夫	真功夫
真信实意	真心实意
真脏实犯	真赃实犯
真知卓见	真知灼见
真知拙见	真知灼见
真珠	珍珠
	榛
箴口	缄口
箴口不言	缄口不言
振耳欲聋	震耳欲聋
振惊	震惊
振聋发溃	振聋发聩
振聋发]	振聋发聩
振振有辞	振振有词
镇坪县	镇平县
震幅	振幅
震古铄今	震古烁今
震憾	震撼
震憾人心	震撼人心
震聋发聩	振聋发聩
争前恐後	争前恐后
争呜	争鸣
争先恐後	争先恐后
征候学	症候学
征状	症状
怔敛无期	征敛无期
蒸气机	蒸汽机
蒸气机车	蒸汽机车
蒸气计	蒸汽计
蒸气涡炉	蒸汽锅炉
蒸气浴	蒸汽浴
蒸汽计	蒸气计
徵发	征发
徵募	征募
徵收	征收
徵文启事	征文启事
徵召	征召
徵兆	征兆
整襟危坐	正襟危坐
整型术	整形术
整型外科	整形外科
正本清沅	正本清源
正大堂煌	正大堂皇
正儿巴经	正儿八经
正喊途	正儿巴经
正襟危座	正襟危坐
正襟威坐	正襟危坐
正经八摆	正经八百
正经八儿	正经八百
证卷	证券
证卷市场	证券市场
证引	征引
政情报导	政情报道
政治局侯补委员	政治局候补委员
症侯	症候
症侯群	征候群
症候不轻	征候不轻
症候明显	征候明显
症兆	征兆
之乎也者	之乎者也
之死不渝	至死不渝
支解	肢解
支离破悴	支离破碎
支票薄	支票簿
支气菅炎	支气管炎
支吾其辞	支吾其词
支吾奇词	支吾其词
支着儿	支招儿
吱吾其词	支吾其词
枝大於本	枝大于本
枝附叶著	枝附叶着
枝窒喑	枝干相持
枝解	肢解
枝离破碎	支离破碎
枝梧	支吾
枝捂	支吾
枝桠	枝丫
枝	枝丫
知不诈愚	智不诈愚
知己知彼百战不殆	知己知彼，百战不殆
知灼渖	知几其神
知尽能索	智尽能索
知其然不知其所以然	知其然，不知其所以然
知其然而不知其所以然	知其然，而不知其所以然
知人口面不知心	知人知面不知心
知识份子	知识分子
知书达礼	知书达理
知水仁山	智水仁山
知无不言言无不尽	知无不言，言无不尽
知小谋大	智小谋大
知小言大	智小言大
知已知彼	知己知彼
知迂之恩	知遇之恩
知之为知之不知为不知	知之为知之，不知为不知
知足长乐	知足常乐
织白守黑	知白守黑
脂麻	芝麻
执径问难	执经问难
执著的追求	执着的追求
执著追求	执着追求
直拔	直拨
直拔电话	直拨电话
直拔功能	直拨功能
直尺天涯	咫尺天涯
直缝如柱	直缝如注
直角座标	直角坐标
直接了当	直截了当
直捷了当	直截了当
直上九宵	直上九霄
直上重宵	直上重霄
直抒已见	直抒己见
直言不违	直言不讳
直言不纬	直言不讳
值得主义	值得注意
职联酋	阿联酋
跖狗吠尧	狗吠尧
跖犬吠尧	犬吠尧
跖犬噬尧	犬噬尧
骨	跖骨
躅	踯躅
止於至善	止于至善
只见树木不见森林	只见树木，不见森林
只可会意不可言传	只可意会，不可言传
只可意会不可言传	只可意会，不可言传
只身飘泊	只身漂泊
只听楼梯响不见人下来	只听楼梯响，不见人下来
只许州官放火不许百姓点灯	只许州官放火，不许百姓点灯
只要功夫深铁杵磨成针	只要功夫深，铁杵磨成针
只争相夕	只争朝夕
只知其一不知其二	只知其一，不知其二
旨酒嘉肴	旨酒佳肴
纸煤儿	纸媒儿
咫尺天崖	咫尺天涯
指东划西	指东画西
指高气扬	趾高气扬
指天划地	指天画地
指o为白	指皂为白
至於	至于
志高气扬	趾高气扬
志在比得	志在必得
制钉者	制定者
制醣	制糖
治郭安邦	治国安邦
治	治疗
质量上层	质量上乘
栉比鳞差	栉比鳞次
致词	致辞
致胜	制胜
致以节日的问侯	致以节日的问候
致之度外	置之度外
智识份子	知识分子
智识阶级	知识阶级
智者千虑必有一失	智者千虑，必有一失
滞碍难行	窒碍难行
置若惘闻	置若罔闻
置偌罔闻	置若罔闻
置死地而后快	置之死地而后快
置于死地而后生	置之死地而后生
置之生死于度外	置生死于度外
置啄	置喙
F後跋前	F后跋前
中国男蓝	中国男篮
中河失舟一壶千金	中河失舟，一壶千金
中坚份子	中坚分子
中恳	中肯
中流底柱	中流砥柱
中流抵柱	中流砥柱
中流失舟一壶千金	中流失舟，一壶千金
中流一	中流一壶
中美州	中美洲
中南美州	中南美洲
中途缀学	中途辍学
中外合壁	中外合璧
中西合壁	中西合璧
中西和璧	中西合璧
中洲	中州
忠言逆耳但利于行	忠言逆耳，但利于行
终身职	终身制
终天之根	终天之恨
盅惑人心	蛊惑人心
锺爱地	钟爱地
锺鼎山林	钟鼎山林
锺灵毓秀	钟灵毓秀
锺鸣鼎食	钟鸣鼎食
锺鸣漏尽	钟鸣漏尽
锺情	钟情
螽羽诜诜	螽羽莘莘
种瓜得瓜种豆得豆	种瓜得瓜，种豆得豆
种籽	种子
种族岐视	种族歧视
仲介	中介
众采众说	博采众说
众口烁金	众口铄金
众口一辞	众口一词
众目睦睦	众目睽睽
众目招彰	众目照彰
众目照彰	众目昭彰
众判亲离	众叛亲离
众矢之地	众矢之的
众说纷云	众说纷纭
众娘g山	众钠山
重蹈复辙	重蹈覆辙
重迭	重叠
重趼	重茧
重峦迭嶂	重峦叠嶂
重气徇名	重气殉名
重气徇命	重气殉命
重气F名	重气徇名
重赏之下必有勇夫	重赏之下，必有勇夫
重施故技	重施故伎
重叟无欺	童叟无欺
重五	重午
重现光采	重现光彩
重宵	重霄
重新起动	重新启动
重P列鼎	重茵列鼎
重用人材	重用人才
重於泰山	重于泰山
重粘土	重黏土
重整齐鼓	重整旗鼓
重足而立侧目而视	重足而立，侧目而视
重足一	重足一迹
州际	洲际
周邦	周邦彦
周穷r匮	周穷恤匮
周未	周末
周瑜打黄盖，一个愿打一个愿挨	周瑜打黄盖，一个愿打，一个愿挨
张	张
Q济	周济
轴後地	轴后地
咒咀	咒诅
绉纹	皱纹
绉褶	皱摺
朱粉面	朱唇粉面
朱皓齿	朱唇皓齿
朱玉面	朱唇玉面
朱No盖	朱幡皂盖
朱罗纪	侏罗纪
朱门酒肉臭路有冻死骨	朱门酒肉臭，路有冻死骨
朱玉敦	朱盘玉敦
朱熔基	朱F基
诛除异已	诛除异己
诛连	株连
诛连九族	株连九族
珠沉玉p	珠沉玉陨
珠光宝器	珠光宝气
珠江三角州	珠江三角洲
珠连壁合	珠连璧合
珠连璧合	珠联璧合
珠联壁合	珠联璧合
珠玉敦	珠盘玉敦
珠玉在傍	珠玉在旁
珠园玉润	珠圆玉润
诸候	诸侯
p粉面	朱唇粉面
p皓齿	朱唇皓齿
p玉面	朱唇玉面
pNo盖	朱N皂盖
p干玉戚	朱干玉戚
p楼碧瓦	朱楼碧瓦
p楼绮户	朱楼绮户
p轮华毂	朱轮华毂
p甍碧瓦	朱甍碧瓦
p弦三叹	朱弦三叹
p颜翠发	朱颜翠发
p颜绿发	朱颜绿发
p衣点头	朱衣点头
蛛丝蚂迹	蛛丝马迹
竹簧	竹黄
竹兰打水	竹篮打水
竹蓝打水	竹篮打水
竹蓝打水一场空	竹篮打水一场空
竹蔑	竹篾
竹滕	竹藤
主薄	主簿
主观想象	主观想像
主弦律	主旋律
主要部份	主要部分
主一无m	主一无适
属於	属于
贮茂	贮藏
柱杖	拄杖
柱杖而行	拄杖而行
祝辞	祝词
祝们	祝你们
著粪佛头	着粪佛头
著名权	署名权
著色	着色
著实	着实
著手	着手
著手成春	着手成春
著手进行	着手进行
著手生春	着手生春
著有成效	卓有成效
筑舍道傍	筑舍道旁
抓髻	髻
抓鬏	鬏
拽穹隼	拽把扶犁
专程竭见	专程谒见
专横拔扈	专横跋扈
专横拨扈	专横跋扈
专力	专利
砖窑厂	砖窑场
转纽	转钮
转弯磨角	转弯抹角
转湾抹角	转弯抹角
转形期	转型期
转游	转悠
转帐	转账
转千里	转斗千里
篆刻x雕	篆刻虫雕
妆聋做哑	装聋作哑
妆束	装束
庄嫁	庄家
装扮配衬	装扮陪衬
装璜	装潢
装聋做哑	装聋作哑
装模着样	装模作样
装骗	撞骗
装怯做勇	装怯作勇
装傻充楞	装傻充愣
装饰钮扣	装饰纽扣
装祯	装帧
装做	装作
壮重地	庄重地
撞头t脑	撞头磕脑
隹人	佳人
追棒	追捧
追本穷沅	追本穷源
追掉	追悼
追茁粜	追欢卖笑
追朔	追溯
追邀	追缴
椎牛发V	椎牛发冢
锥板式粘度计	锥板式黏度计
锥刀之未	锥刀之末
锥间盘	椎间盘
锥心泣血	椎心泣血
坠落腐化	堕落腐化
缀学	辍学
惴揣不安	惴惴不安
谆谆告戒	谆谆告诫
准备起程	准备启程
卓而不群	卓尔不群
卓跞	卓荦
拙咀笨舌	拙嘴笨舌
拙拙	咄咄
拙拙逼人	咄咄逼人
捉襟见胄	捉襟见肘
捉迷茂	捉迷藏
捉贼捉脏	捉贼捉赃
桌而不群	卓尔不群
斫为朴	斫雕为朴
斫h为朴	斫雕为朴
斫轮老手	勐掷鲜
着有	著有
着着	招招
濯发难数	擢发难数
仔细端祥	仔细端详
姿式	姿势
姿意	恣意
姿意胡为	恣意胡为
姿意妄为	恣意妄为
姿意妄行	恣意妄行
资才	资财
资金调拔	资金调拨
谘经诹史	咨经诹史
谘文	咨文
谘议局	咨议局
孳生	滋生
孳孳	孜孜
孳孳不倦	孜孜不倦
UU	孜孜
锱珠必较	锱铢必较
C基	CZ
趄却顾	趑趄却顾
子宫畸瘤	子宫肌瘤
子鸡	仔鸡
子粒	籽粒
子棉	籽棉
子母@	子母扣
子然一身	孑然一身
子实	籽实
子兽	仔兽
子细	仔细
子虚无有	子虚乌有
子畜	仔畜
子鱼	仔鱼
子猪	仔猪
紫妍红	姹紫嫣红
字勘句酌	字斟句酌
自抱自弃	自暴自弃
自壁无暇	白璧无瑕
自残骨内	自残骨肉
自出机轴	自出机杼
自出新裁	自出心裁
自负赢亏	自负盈亏
自各儿	自个儿
自顾不遐	自顾不暇
自刽以下	自郐以下
自花受粉	自花授粉
自画象	自画像
自己自足	自给自足
自家人不说客套	自家人不说客套话
自不息	自强不息
自觉自原	自觉自愿
自立更生	自力更生
自媒自f	自媒自炫
自名得意	自鸣得意
自明得意	自鸣得意
自鸣清高	自命清高
自曝自弃	自暴自弃
自情不息	自强不息
自然辨政法	自然辩证法
自然历	自然力
自我作故	自我作古
自相惊忧	自相惊扰
自行其事	自行其是
自叙	自序
自f自媒	自炫自媒
自寻烦脑	自寻烦恼
自意妄为	恣意妄为
自园其说	自圆其说
自知之名	自知之明
自治洲	自治州
自做聪明	自作聪明
自做主张	自作主张
自做自受	自作自受
恣态	姿态
综光瓦亮	锃光瓦亮
综计	总计
综括	总括
总得来说	总的来说
总分类帐户	总分类账户
总帐	总账
纵横俾阖	纵横捭阖
纵横驰聘	纵横驰骋
纵横跤错	纵横交错
纵虎出匣	纵虎出柙
纵座标	纵坐标
走露	走漏
走露风声	走漏风声
走头无路	走投无路
走帐	走账
足球厂	足球场
足委会	组委会
足足有馀	足足有余
卒免于难	幸免于难
阻击敌人	狙击敌人
阻拢	阻挠
钻懒帮f	钻懒帮闲
嘴巴一瞥	嘴巴一撇
嘴弄舌	调嘴弄舌
最高纪录	最高记录
最后通谍	最后通牒
最後地	最后地
最佳部份	最佳部分
最在利于	最有利于
罪不及奴	罪不及孥
罪魁祸一	罪魁祸首
罪业深重	罪孽深重
醉熏熏	醉醺醺
醉薰薰	醉醺醺
尊循	遵循
左邻右社	左邻右舍
左倾份子	左倾分子
左右逢沅	左右逢源
左右铭	座右铭
左证	佐证
佐治亚理工学院	乔治亚理工学院
作爱	做爱
作崇	作祟
作出来	做出来
作到	做到
作多	做多
作工	做工
作官	做官
作鬼	做鬼
作鬼脸	做鬼脸
作辑	作揖
作苦工	做苦工
作礼拜	做礼拜
作眉作眼	做眉做眼
作媒	做媒
作梦	做梦
作梦也没想到	做梦也没想到
作梦者	做梦者
作神作鬼	做神做鬼
作生意	做生意
作事	做事
作事老到	做事老到
作手脚	做手脚
作威作得	作威作福
作戏	做戏
作小服低	做小伏低
作学问	做学问
作业薄	作业簿
作育人材	作育英才
作月子	坐月子
作贼	做贼
作贼心虚	做贼心虚
作辗轧声	作碾轧声
作张作势	做张做势
作庄	坐庄
坐并观天	坐井观天
坐次	座次
坐地分脏	坐地分赃
坐儿	座儿
坐而待弊	坐而待毙
坐而待	坐而待毙
坐山吃空	坐吃山空
坐收鱼利	坐收渔利
坐谈会	座谈会
坐位	座位
坐位表	座位表
坐卧针	坐卧针毡
坐无虚席	座无虚席
坐象	坐像
坐阵	坐镇
坐著地	坐着地
座标	坐标
座标轴	坐标轴
座落	坐落
座落于	坐落于
座落在	坐落在
做弊	作弊
做壁上观	作壁上观
做恶	作恶
做恶多端	作恶多端
做法自毙	作法自毙
做工夫	做功夫
做奸犯科	作奸犯科
做茧自缠	作茧自缚
做茧自缚	作茧自缚
做卖买	做买卖
做美	作美
做鸟兽散	作鸟兽散
做弄	作弄
做如是观	作如是观
做声	作声
做威做福	作威作福
做为	作为
做小服低	做小伏低
做秀	作秀
做一日和尚	做一天和尚撞一天钟
做一天和尚一天钟	做一天和尚撞一天钟
做月子	坐月子
i脓	溃脓
q考q老	栲栳
	挣揣
执鞭随蹬	执鞭随镫
死心踏地	死心塌地
有利措施	有力措施